; ibus 拼音输入法--自定义短语配置文件
; 
; Usage:
;   1. copy this file to ~/.config/ibus/pinyin/phrases.txt
;   2. restart ibus: ibus-daemon -drx
; 
; 说明：
;   **注意**
;       修改后请重新启动输入法
;       或者运行下面命令：pkill -x -u $USERNAME ibus-engine-pinyin
;   格式：
;       英文字符串=短语
;       英文字符串=#动态短语
;   动态短语：
;       函数            含义            举例
;       ${year}         年(4位)         2006、2008
;       ${year_yy}      年(2位)         06、08
;       ${month}        月              12、8、3
;       ${month_mm}     月              12、08、03
;       ${day}          日              3、13、22
;       ${day_dd}       日              03、13、22
;       ${weekday}      星期            0、1、2、5、6
;       ${fullhour}     时(24小时制)    02、08、13、23
;       ${halfhour}     时(12小时制)    02、08、01、11
;       ${ampm}         AM、PM(英)      AM、PM（大写）
;       ${minute}       分              02、08、15、28
;       ${second}       秒              02、08、15、28
;       ${year_cn}      年(中文4位)     二〇〇六
;       ${year_yy_cn}   年(中文2位)     〇六
;       ${month_cn}     月(中文)        十二、八、三
;       ${day_cn}       日(中文)        三、十三、二十二
;       ${weekday_cn}   星期(中文)      日、一、二、五、六
;       ${fullhour_cn}  月(中文24时制)  二、八、十三、二十三
;       ${halfhour_cn}  时(中文12时制)  二、八、一、十一
;       ${ampm_cn}      上午下午(中文)  上午、下午
;       ${minute_cn}    分(中文)        零二、零八、十五、二十八
;       ${second_cn}    秒(中文)        零二、零八、十五、二十八

a=啊
aa=阿
aab=阿爸
aae=阿
aag=阿哥
aah=啊哈
aaj=锕
aak=呵
aal=阿拉
aam=阿妹
aap=阿婆
aay=阿姨
ab=安保
ad=安定
af=安分
ag=昂贵
ah=昂
ahg=昂贵
aho=肮
ahq=昂起
ahr=盎然
ahs=盎司
ahu=昂首
ahy=盎
ahz=肮脏
ai=爱
aia=皑皑
aib=癌
aic=艾
aid=挨打
aie=隘
aif=挨
aig=爱国
aih=爱好
aii=哀愁
aij=锿
aik=唉
ail=爱恋
aim=爱慕
ain=嫒
aio=暧
aip=爱
aiq=爱情
air=爱人
ais=哀思
ait=埃
aiu=矮
aiv=挨着
aiw=哀
aix=爱心
aiy=霭
aiz=艾滋
aj=安静
ak=拗口
al=按理
am=吗
an=安
ana=暗暗
anb=案
anc=暗藏
and=鹌
ane=岸
anf=按
ang=庵
anh=黯
ani=安插
anj=铵
ank=唵
anl=按理
anm=桉
ann=按钮
ano=暗
anp=安排
anq=氨
anr=俺
ans=暗算
ant=埯
anu=暗示
anv=按照
anw=安慰
anx=安心
any=谙
anz=案子
ao=奥
aoa=嗷嗷
aob=翱
aod=澳
aof=熬
aog=鏖
aoh=懊悔
aok=嗷
aol=凹
aom=傲慢
aon=媪
aop=袄
aoq=傲气
aor=傲
aos=懊丧
aot=坳
aou=傲视
aov=澳洲
aox=懊
aoy=岙
aoz=遨
ap=安排
aq=安全
ar=黯然
as=暗算
at=凹凸
au=按时
av=按照
aw=安慰
ax=爱惜
ay=安逸
az=暗自
b=不
ba=把
baa=鲅
bab=爸
bac=芭
bad=灞
bae=岜
baf=拔
bag=靶
bah=疤痕
bai=拔出
baj=钯
bak=吧
bal=耙
bam=粑
bap=八
baq=霸权
bas=罢
bat=坝
bau=把守
bav=巴
baw=把握
bax=把戏
bay=霸
baz=跋
bb=滨
bba=鬓
bbb=宾
bbd=濒
bbe=豳
bbf=摈
bbg=髌
bbh=滨海
bbj=镔
bbk=宾客
bbl=濒临
bbm=彬
bbo=膑
bbp=宾朋
bbr=傧
bbs=缤
bbu=豳
bbw=斌
bc=报
bca=鲍
bcb=包
bcb=鸨
bcc=薄
bcd=瀑
bce=报恩
bcf=抱
bcg=报告
bch=爆
bci=报仇
bcj=保健
bck=包括
bcl=保留
bcm=保密
bcn=保暖
bco=暴
bcp=褓
bcq=抱歉
bcr=保
bcs=报送
bct=煲汤
bcu=饱
bcv=豹
bcv=龅
bcw=褒
bcx=保险
bcy=雹
bcz=趵
bd=白
bda=百
bdc=白菜
bdd=拜读
bdf=摆
bdg=白宫
bdh=稗
bdk=败
bdm=柏
bdn=百年
bdp=白
bdr=佰
bds=百色
bdt=拜托
bdu=拜
bdz=摆在
be=不二
bf=本
bfa=本
bfb=坌
bfc=苯
bfd=奔
bff=本分
bfg=本该
bfh=本行
bfi=奔驰
bfj=锛
bfk=本科
bfl=本来
bfn=犇
bfp=奔跑
bfr=本人
bfs=畚
bft=奔腾
bfu=贲
bfv=笨
bfw=本文
bfx=本息
bfy=本月
bg=蹦
bgb=甭
bge=崩
bgf=迸发
bgg=甭管
bgi=蚌
bgk=嘣
bgp=祊
bgs=绷
bgu=泵
bgv=绷着
bgx=甭想
bgz=迸
bh=帮
bhd=浜
bhf=邦
bhi=蚌
bhj=镑
bhk=蚌壳
bhm=棒
bho=膀
bhp=绑票
bhq=棒球
bhr=傍
bhs=绑
bhu=磅
bhv=帮助
bhw=傍晚
bhx=帮凶
bhy=谤
bhz=绑在
bi=比
bia=彼岸
bib=毙
bic=蔽
bic=薜
bid=必
bie=陛
bif=比方
big=庇
bih=秕
bii=彼
bij=比较
bik=鄙
bil=秘鲁
bim=闭
bin=婢
bio=睥
bip=币
biq=狴
bir=俾
bis=比赛
bit=畀
biu=壁
biu=璧
biv=笔
biw=碧
bix=愎
biy=必要
biz=避
bj=办
bja=办案
bjb=颁
bjc=半仓
bjd=半
bje=阪
bjf=搬
bjh=办好
bji=半场
bjj=钣
bjk=版块
bjl=瓣
bjm=板
bjp=版
bjq=版权
bjr=伴
bjs=绊
bjt=坂
bjv=般
bjw=班
bk=并
bka=丙
bkb=病
bkc=并存
bkd=冰
bkf=摒
bkg=疒
bkh=炳
bki=秉承
bkj=并将
bkk=并可
bkl=冰冷
bkm=柄
bkp=秉
bkq=兵
bkr=病人
bks=病死
bkt=病痛
bku=饼
bkv=兵种
bkw=禀
bkz=并在
bl=本来
bm=边
bma=鳊
bmb=窆
bmc=苄
bmd=汴
bmf=蝙蝠
bmg=鞭
bmh=扁
bmh=煸
bmi=蝙
bmj=边界
bmk=贬
bml=辩
bml=辫
bmm=编码
bmp=褊
bmq=变迁
bmr=便
bms=编
bms=缏
bmt=变态
bmu=砭
bmv=笾
bmw=变
bmx=忭
bmz=遍
bn=表
bna=鳔
bnb=瘭
bnd=表达
bng=表格
bnh=彪
bni=标出
bnj=镖
bnl=表露
bnm=标
bnn=婊
bno=膘
bnp=裱
bnq=飙
bnr=俵
bns=表嫂
bnt=标题
bnu=表示
bnv=标准
bnw=表外
bnx=表现
bny=表演
bnz=婊子
bo=拨
boa=博爱
bob=帛
boc=薄
bod=波
boe=波恩
bof=播
boh=拨号
boi=播出
boj=铂
bok=啵
bol=卜
bom=柏
bon=拨弄
boo=膊
bop=剥皮
boq=博取
bor=伯
bos=播送
bot=波涛
bou=博
bov=剥
bow=玻
box=博学
boy=博弈
boz=跛
bp=别
bpb=瘪
bpd=憋
bpg=别管
bpi=别吵
bpj=别急
bpk=别
bpl=别离
bpm=别忙
bpn=别扭
bpp=别怕
bpq=别去
bpr=别人
bps=憋死
bpt=别提
bpv=别致
bpw=别忘
bpx=别想
bpy=别用
bpz=别再
bq=并且
br=不然
bs=比赛
bt=不同
bu=部
bua=不
buc=不错
bud=不但
bue=不二
buf=捕
bug=不管
buh=不会
bui=补充
buj=钚
buk=哺
bul=卜
bul=瓿
bum=不卖
bun=不能
buo=晡
bup=补
buq=补全
bur=不如
bus=不算
but=埠
buu=布
buv=步
bux=怖
buy=醭
buz=踄
bv=保证
bw=被
bwa=悲哀
bwb=卑鄙
bwc=蓓
bwd=北大
bwe=陂
bwf=悲
bwg=鞴
bwh=焙
bwi=备查
bwj=钡
bwk=呗
bwl=北
bwm=杯
bwo=北欧
bwp=卑
bwp=褙
bwq=狈
bwr=倍
bws=背诵
bwt=悲痛
bwu=碑
bwu=孛
bwv=备注
bww=备
bwx=悖
bwy=备用
bwz=倍增
bx=必须
by=必要
bz=不再
c=才
ca=擦
cab=擦背
cac=擦擦
cad=擦掉
caf=擦
cag=擦干
cah=擦汗
cai=擦除
cak=嚓
cal=擦亮
cap=擦破
cau=礤
cav=擦着
cax=擦洗
cb=从不
cc=草
cca=曹
ccb=草包
ccc=草
ccd=漕
ccf=操
ccg=草稿
cci=螬
ccj=草芥
cck=嘈
ccl=操劳
ccm=槽
ccn=草拟
ccp=操盘
ccq=草签
ccr=肏
cct=草图
ccu=草率
ccv=艚
ccw=草屋
ccx=操心
ccy=草原
ccz=操作
cd=菜
cda=才
cdb=财宝
cdc=蔡
cdd=彩电
cdf=财富
cdg=才干
cdh=才华
cdi=财产
cdj=财经
cdk=财
cdl=材料
cdm=材
cdn=才能
cdo=睬
cdp=采
cdq=猜
cds=彩色
cdt=踩踏
cdu=裁
cdv=财政
cdw=财务
cdx=彩信
cdy=采用
cdz=踩
ce=测
ceb=侧边
ced=测
cee=侧耳
cef=册封
ceh=策划
cei=厕
cel=测量
cem=侧面
cep=册
cer=侧
ces=厕所
ceu=测试
cev=策
cew=侧卧
cex=恻
cey=测验
cez=册子
cf=岑
cfc=参差
cfd=涔
cfe=岑
cfs=参
cg=曾
cgb=曾
cgc=层次
cgd=层叠
cgj=曾经
cgk=噌
cgm=层面
cgr=曾任
cgu=层
cgy=曾有
cgz=蹭
ch=藏
chb=苍白
chc=苍
chd=沧
chh=沧海
chi=仓储
chk=仓库
chl=苍老
chm=苍茫
chn=藏匿
chp=藏品
chq=苍穹
chr=仓
chs=沧桑
cht=苍天
chu=藏书
chv=舱
chw=玱
chy=苍蝇
chz=藏在
ci=次
cia=刺
cib=慈
cic=茨
cid=瓷
cie=刺耳
cif=此番
cig=赐给
cih=伺候
cii=此处
cij=刺激
cik=赐
cil=此类
cim=糍
cin=此乃
cip=祠
ciq=辞
cir=伺
cit=辞退
ciu=磁
civ=此
ciw=此外
cix=次序
ciy=词
ciz=词组
cj=参
cja=惨案
cjb=惨败
cjc=残存
cjd=残
cjf=掺
cjg=餐馆
cjh=灿
cji=餐车
cjj=参加
cjk=参考
cjl=餐
cjm=骖
cjn=残年
cjp=残破
cjq=残缺
cjr=残忍
cjs=参
cjt=蚕
cju=孱
cjv=惨重
cjw=璨
cjx=惨
cjy=参与
cjz=惨遭
ck=参考
cl=从来
cm=聪明
cn=才能
co=错
coa=错爱
cob=痤
coc=措辞
cod=锉刀
coe=嵯
cof=搓
cog=错过
coh=撮合
coi=厝
coj=锉
cok=错开
col=鹾
com=错码
coo=脞
cop=错判
cor=搓揉
cot=蹉跎
cou=矬
cov=挫折
cow=错误
cox=搓洗
coz=蹉
cp=存盘
cq=从前
cr=窜
crb=窜
crd=窜到
crf=攒
crg=篡改
cri=窜出
crj=镩
crp=爨
crq=篡权
crr=汆
crt=窜逃
crv=篡
crw=篡位
crz=蹿
cs=从
csb=匆
csc=葱
csd=淙
cse=聪
csf=从犯
csh=聪慧
csj=从今
csk=从宽
csl=从来
csm=骢
csp=囱
csq=从前
csr=丛
css=从速
cst=从头
csu=从事
csv=从中
csw=琮
csx=悰
csy=从业
csz=从早
ct=从头
cu=粗
cub=粗暴
cuc=蔟
cud=殂
cuf=粗放
cug=粗犷
cuh=粗话
cui=徂
cuj=促进
cuk=粗口
cul=粗鲁
cum=粗
cuq=猝
cur=促
cus=粗俗
cut=粗体
cuu=促使
cuv=簇
cuw=蹙
cux=粗心
cuy=醋
cuz=蹴
cv=催
cvb=瘁
cvc=萃
cvd=淬
cve=崔
cvf=摧
cvh=焠
cvi=催产
cvk=啐
cvl=翠绿
cvm=粹
cvm=毳
cvo=脆
cvr=催
cvu=催生
cvv=催债
cvw=璀
cvx=翠
cw=错误
cx=才行
cy=村
cya=寸
cyb=寸步
cyc=寸草
cyd=存档
cyf=存放
cyg=存根
cyh=存活
cyi=存储
cyk=吋
cyl=存量
cym=村
cyp=存盘
cyq=存取
cyr=存入
cys=皴
cyu=存
cyv=存折
cyw=存为
cyx=忖
cyy=存疑
cyz=存在
cz=凑
czc=凑凑
czd=凑
czg=凑够
czh=凑合
czi=辏
czj=凑近
czm=楱
czo=腠
czq=凑巧
czu=凑数
czz=凑足
d=的
da=大
daa=大
dab=瘩
dac=荙
dad=耷
dae=大额
daf=打
dag=鞑
dag=靼
dah=大会
dai=打岔
daj=打架
dak=哒
dal=大量
dam=大门
dan=妲
dap=褡
daq=大气
dar=打扰
das=打算
dat=大腿
dau=沓
dav=答
daw=大王
dax=怛
day=答应
daz=达
db=代表
dc=到
dca=到
dcb=盗版
dcc=到此
dcd=盗
dcf=捣
dcg=祷告
dch=稻
dci=导出
dcj=帱
dck=叨
dcl=道理
dcm=梼
dcn=悼念
dcp=岛
dcq=氘
dcr=倒
dcs=导
dct=倒退
dcu=倒是
dcv=刀
dcw=到位
dcx=悼
dcy=导演
dcz=道
dd=代
dda=歹
ddb=呆板
ddc=代词
ddd=殆
dde=戴尔
ddf=带
ddg=带给
ddi=待
ddj=代价
ddk=呆
ddl=带来
ddm=棣
ddp=待批
ddr=贷
dds=怠
ddt=埭
ddu=戴
ddw=玳
ddx=代谢
ddy=甙
ddz=逮
de=得
deb=的
ded=得到
def=得分
dei=德
dej=锝
del=得了
dep=得票
det=地
deu=得胜
dev=得知
dew=德文
dex=得悉
dey=得意
dez=得罪
df=地方
dg=等
dgb=登报
dgd=澄
dge=嶝
dgh=灯
dgj=登记
dgk=噔
dgl=登陆
dgm=登门
dgo=瞪
dgp=灯泡
dgr=等人
dgt=等同
dgu=磴
dgv=登
dgx=等下
dgy=邓
dgz=蹬
dh=当
dha=档案
dhb=宕
dhc=荡
dhd=当地
dhf=挡
dhg=当官
dhh=当红
dhj=铛
dhl=当了
dhm=档
dhn=当年
dhp=裆
dhq=当前
dhr=当然
dht=当天
dhu=凼
dhv=当众
dhw=珰
dhx=党
dhy=谠
dhz=当作
di=地
dia=低矮
dib=弟
dic=蒂
did=涤
die=第二
dif=抵
dig=底
dii=抵触
dij=镝
dik=嘀
dim=棣
din=嫡
dio=睇
dip=地盘
diq=敌
dir=低
dis=缔
dit=堤
diu=氐
div=第
diw=帝
dix=翟
diy=谛
diy=羝
diz=递
dj=但
dja=石
djb=单
djb=疸
djc=萏
djd=淡
dje=耽
djf=担
djg=弹
dji=单纯
djj=单击
djk=啖
djl=胆量
djm=淡漠
djn=胆囊
djo=胆
djp=丹
djq=氮
djr=儋
djs=单色
djt=蛋挞
djv=蛋
djw=单位
djx=惮
djy=诞
djz=胆子
dk=定
dka=丁
dkb=疔
dkc=顶层
dkd=顶
dke=耵
dkf=顶峰
dkg=订购
dkh=定会
dkj=钉
dkk=叮
dkm=定名
dkn=定能
dko=盯
dkp=订票
dkq=定期
dkr=仃
dkt=町
dku=碇
dkv=叮嘱
dkw=玎
dkx=定下
dky=订
dkz=定做
dl=到了
dm=点
dmb=癫
dmc=点菜
dmd=滇
dme=巅
dmf=垫
dmg=店
dmh=电话
dmi=电池
dmj=钿
dmk=癫狂
dml=电
dmm=店面
dmn=电脑
dmp=点评
dmr=佃
dms=点算
dmt=坫
dmu=颠
dmv=簟
dmw=玷
dmx=惦
dmy=电影
dmz=踮
dn=调
dna=鲷
dnb=调拨
dnd=凋
dnf=掉
dng=吊诡
dnh=调换
dni=调查
dnj=钓
dnk=吊
dnl=掉了
dnm=刁蛮
dnn=刁难
dnp=雕
dnr=调任
dns=雕塑
dnt=掉头
dnu=屌
dnv=刁
dnx=掉下
dnz=掉在
do=多
doa=多爱
dob=多半
doc=多次
dod=夺
doe=堕
dof=掇
dog=度
doh=多好
doi=多处
doj=朵
dok=咄
dol=多了
dom=驮
don=多年
dop=裰
doq=夺取
dor=多人
dos=缍
dot=垛
dou=躲
dov=舵
dow=多问
dox=惰
doy=多余
doz=跺
dp=跌
dpa=鲽
dpb=爹
dpd=跌倒
dpf=揲
dpg=瓞
dpi=蝶
dpj=跌价
dpk=喋
dpl=耋
dpn=爹娘
dpp=牒
dpq=跌去
dpr=跌入
dps=跌死
dpt=垤
dpu=碟
dpv=跌至
dpy=叠
dpz=迭
dq=丢
dqd=丢掉
dqg=丢给
dqi=丢丑
dqj=铥
dql=丢了
dqp=丢
dqq=丢弃
dqr=丢人
dqu=丢失
dqx=丢下
dr=段
dra=断案
drb=断臂
drc=短促
drd=短短
drf=短发
drg=断根
drh=煅
dri=短处
drj=锻
drk=断开
drl=端
drm=断
drn=断奶
drp=短篇
drq=短期
drr=断然
drs=缎
drt=短途
dru=短
drv=簖
drx=短线
dry=短语
drz=短暂
ds=动
dsa=东
dsb=东北
dsc=董
dsd=洞
dse=峒
dsf=洞房
dsh=动画
dsi=洞察
dsj=动机
dsk=咚
dsl=懂了
dsm=栋
dsn=东南
dso=胴
dsp=夂
dsq=氡
dsr=侗
dss=冻死
dst=垌
dsu=硐
dsw=冬
dsx=懂
dsy=动员
dsz=动作
dt=代替
du=读
dua=独爱
dub=赌博
duc=芏
dud=渡
duf=毒
dug=度
duh=黩
dui=赌场
duj=镀
duk=赌
dul=都
dum=杜
dun=妒
duo=肚
dup=牍
duq=独
dus=堵塞
dut=堵
duu=督
duu=蠹
duv=笃
duw=读完
dux=毒性
duy=读
duz=独自
dv=对
dva=对岸
dvb=兑
dvc=对此
dvd=对待
dve=队
dvi=对称
dvj=镦
dvk=对抗
dvl=对了
dvm=对面
dvn=对内
dvr=对人
dvt=堆
dvu=碓
dvv=对着
dvw=憝
dvx=对象
dvy=怼
dvz=对子
dw=得
dwi=得
dx=东西
dxk=嗲
dy=顿
dyd=沌
dyf=蹲伏
dyh=炖
dyj=钝
dyk=吨
dyo=盹
dyp=盾
dyt=墩
dyu=礅
dyw=敦
dyz=蹲
dz=都
dza=豆
dzb=窦
dzc=蔸
dzd=斗
dze=陡
dzf=抖
dzg=都给
dzh=都好
dzi=蚪
dzj=钭
dzk=都可
dzl=都
dzm=都没
dzn=都能
dzo=斗殴
dzp=兜
dzr=陡然
dzs=抖擞
dzu=都是
dzv=篼
dzx=都想
dzz=逗
e=二
ea=恩爱
ec=恩赐
ee=额
eea=鳄
eeb=额
eec=萼
eed=额度
eee=峨
eef=扼
eeg=恶棍
eeh=恶化
eei=厄
eej=锷
eek=呃
eel=恶劣
eem=阏
een=娥
eeo=腭
eeq=恶气
eer=俄
ees=饿死
eet=额头
eeu=饿
eev=遏制
eew=噩
eex=愕
eey=恶
eez=遏
ei=诶
en=恩
ena=恩爱
enb=奀
enc=蒽
end=恩德
enf=摁
enh=恩惠
eni=恩仇
enk=嗯
enq=恩情
enr=恩人
enu=恩师
eny=恩怨
enz=恩泽
eq=而且
er=而
era=耳
erb=而不
erc=二次
erd=尔
ere=鸸
erf=而非
erg=儿歌
erh=而后
eri=而成
erj=铒
erk=儿科
erl=而来
erm=耳目
ern=儿女
erp=儿
erq=而且
err=佴
ers=耳塞
ert=儿童
eru=饵
erv=二者
erw=珥
erx=儿戏
ery=贰
erz=迩
es=饿死
ex=儿戏
ey=而已
ez=儿子
f=非
fa=法
fab=发布
fac=发财
fad=发呆
faf=发放
fag=法规
fah=发火
fai=发出
faj=发觉
fak=罚款
fal=法律
fam=阀
fan=发怒
fap=乏
faq=发起
far=伐
fas=罚
fat=法庭
fau=砝
fav=发
faw=珐
fax=发行
fay=发言
faz=发作
fb=方便
fc=讽刺
fd=反对
fe=反而
ff=分
ffa=鲼
ffb=忿
ffc=芬
ffd=奋
ffd=汾
ffe=份额
fff=纷纷
ffg=分割
ffh=分号
ffi=分成
ffj=鼢
ffk=吩
ffl=分类
ffm=粉
ffn=愤怒
ffp=分配
ffq=氛
ffr=份
ffs=纷
fft=坟
ffu=分神
ffv=分钟
ffw=玢
ffx=愤
ffy=酚
ffz=分子
fg=风
fga=丰
fgb=疯
fgc=葑
fgd=冯
fge=峰
fgf=奉
fgg=风格
fgh=烽
fgi=蜂
fgj=锋
fgk=唪
fgl=风力
fgm=枫
fgp=奉陪
fgq=风气
fgr=俸
fgs=缝
fgt=封
fgu=砜
fgv=风中
fgw=风味
fgx=奉献
fgy=讽
fgz=逢
fh=放
fha=鲂
fhb=方便
fhc=芳
fhd=方
fhe=防
fhf=邡
fhg=放过
fhh=房
fhi=彷
fhj=钫
fhk=访客
fhl=放了
fhm=枋
fhn=妨
fho=肪
fhp=放屁
fhr=仿
fhs=纺
fht=坊
fhu=防守
fhv=舫
fhw=防伪
fhx=放心
fhy=访
fhz=放在
fi=非常
fj=反
fja=翻案
fjb=翻倍
fjc=范
fjd=泛
fje=反而
fjf=反复
fjg=犯规
fjh=烦
fji=反查
fjj=凡
fjj=钒
fjk=贩
fjl=烦了
fjm=梵
fjm=樊
fjn=烦恼
fjp=翻
fjq=犯
fjr=凡人
fjs=反思
fjt=畈
fju=饭
fju=矾
fjv=反之
fjw=璠
fjy=反应
fjz=返
fk=分开
fl=费了
fm=方面
fn=烦恼
fo=佛
fof=佛法
fog=佛光
foj=佛教
fok=佛龛
fom=佛门
for=佛
fos=佛寺
fot=佛堂
fou=佛山
fov=佛珠
fox=佛像
foy=佛爷
foz=佛祖
fp=分配
fq=放弃
fr=否认
fs=放松
ft=繁体
fu=副
fua=夫
fub=富
fuc=芙
fud=负
fue=附
fuf=扶
fuf=敷
fug=府
fuh=馥
fui=辅
fui=蜉
fuj=幅
fuk=赋
ful=孵
fum=驸
fun=妇
fuo=服
fuo=脯
fup=福
fuq=氟
fur=付
fur=俯
fus=缚
fut=赴
fuu=砩
fuv=符
fuv=弗
fuw=服务
fux=覆
fuy=讣
fuz=跗
fv=反正
fw=费
fwa=鲱
fwb=痱
fwc=菲
fwd=沸
fwe=飞蛾
fwf=斐
fwg=废
fwh=扉
fwj=镄
fwk=匪
fwl=非
fwm=榧
fwn=妃
fwo=肥
fwp=肥胖
fwq=狒
fwr=废人
fws=绯
fwt=沸腾
fwu=费神
fwv=飞
fww=废物
fwx=悱
fwy=诽
fwz=肥皂
fx=发现
fy=反应
fz=否
fzb=否
fzd=否定
fzj=否决
fzw=缶
fzz=否则
g=个
ga=嘎
gaa=夹
gag=嘎嘎
gai=轧
gaj=旮
gak=噶
gal=咖喱
gam=伽马
gan=尕
gao=胳
gar=伽
gau=尬
gav=嘎吱
gax=尜
gb=根本
gc=高
gca=高傲
gcb=皋
gcc=藁
gcd=高度
gce=高额
gcf=搞
gcg=高高
gch=稿
gci=高超
gcj=镐
gck=高考
gcl=高了
gcm=糕
gcm=槁
gcn=告
gco=杲
gcp=睾
gcq=搞清
gcr=高人
gcs=缟
gct=告退
gcu=高手
gcv=篙
gcw=膏
gcx=高效
gcy=羔
gcz=稿子
gd=该
gda=丐
gdc=芥
gdd=溉
gde=陔
gdf=盖房
gdg=改革
gdh=改换
gdi=改成
gdj=改
gdk=赅
gdl=改了
gdm=概
gdn=戤
gdo=胲
gdr=改日
gds=该死
gdt=垓
gdu=改善
gdv=改正
gdw=改为
gdx=改下
gdy=盖
gdz=改造
ge=各
gea=哥
geb=割
gec=葛
ged=歌
gee=隔
gef=搁
geg=骼
geh=隔阂
gei=蛤
gej=铬
gek=嗝
gel=哿
gem=格
gem=阁
gen=革
geo=胳
gep=袼
geq=歌曲
ger=鸽
ges=纥
get=圪
geu=搿
gev=舸
gew=各位
gex=各项
gey=盖
gez=各自
gf=跟
gfa=亘
gfb=根本
gfc=茛
gfd=根底
gfe=艮
gff=跟风
gfg=亘古
gfi=根除
gfj=根据
gfk=哏
gfl=跟了
gfm=根
gfq=跟前
gfs=跟随
gfu=跟上
gfv=艮
gfy=根源
gfz=跟
gg=更
gga=鲠
ggb=更不
ggc=更惨
ggd=更多
gge=耿
ggg=庚
ggh=更好
ggi=更差
ggk=哽
ggl=耕
ggm=梗
ggn=更难
ggq=更强
ggs=绠
ggt=埂
ggu=更少
ggv=颈
ggw=更为
ggx=更新
ggy=羹
ggz=更早
gh=刚
gha=港澳
ghb=港币
ghc=刚才
ghd=港
ghe=岗
ghf=缸
ghh=刚好
ghi=刚吃
ghj=钢
ghk=冈
ghl=戆
ghm=杠
gho=肛
ghq=钢琴
ghs=纲
ght=港台
ghu=港式
ghv=筻
ghw=岗位
ghx=刚学
ghy=纲要
ghz=刚走
gi=过程
gj=干
gja=甘
gjb=疳
gjc=苷
gjd=淦
gje=感恩
gjf=擀
gjh=秆
gji=感触
gjj=感觉
gjk=赶快
gjl=赣
gjm=杆
gjn=甘
gjo=肝
gjp=赶跑
gjq=感情
gjr=干扰
gjs=绀
gjt=赶
gju=尴
gjv=敢
gjw=感
gjx=感
gjy=酐
gk=怪
gkc=怪才
gkd=怪诞
gkf=拐
gkg=乖乖
gkh=怪话
gkl=怪了
gkm=拐卖
gkp=怪癖
gkq=乖
gkr=怪人
gkt=怪胎
gku=怪事
gkv=拐杖
gkw=拐弯
gkx=怪
gky=怪异
gkz=怪罪
gl=光
glb=光标
glc=光彩
gld=广
glf=广泛
glg=广告
glh=光滑
gli=广场
glj=逛街
glk=咣
glm=桄
gln=光年
glo=胱
glp=光凭
glq=犷
glr=光荣
gls=光速
glt=光头
glv=广州
glw=广
glx=光
glz=逛
gm=干嘛
gn=功能
go=过
gob=馘
goc=过错
god=过渡
goe=聒
gof=掴
gog=过关
goh=过后
goi=蜾
goj=锅
gok=国
gol=果
gom=椁
gon=过年
gop=虢
goq=猓
gor=果然
gos=果酸
got=埚
gou=果实
gov=国债
gow=郭
gox=过小
goy=过于
goz=聒噪
gp=股票
gq=过去
gr=关
gra=鳏
grb=官
grc=莞
grd=灌
grf=罐
grg=观光
grh=爟
gri=观察
grj=关键
grk=观看
grl=管理
grm=棺
grn=观念
grp=盥
grq=关切
grr=倌
grs=纶
grt=贯通
gru=馆
grv=管
grw=琯
grx=惯
gry=观
gs=共
gs=公司
gsa=工
gsb=公
gsc=恭
gsd=觥
gsf=拱
gsg=贡
gsg=汞
gsh=工会
gsi=蚣
gsj=工具
gsk=公开
gsl=龚
gsm=共鸣
gsn=功能
gso=肱
gsp=公平
gsq=供求
gsr=供
gss=公司
gst=共同
gsu=躬
gsv=弓
gsw=珙
gsx=共享
gsy=公益
gsz=工作
gt=沟通
gu=古
gua=鲴
gub=谷
guc=菇
gud=沽
gud=觚
gue=崮
guf=股份
gug=鹘
guh=雇
gui=顾
guj=锢
guk=固
gul=骨
gum=梏
gun=姑
guo=股
gup=股票
guq=股权
gur=估
gus=罟
gut=骨头
guu=鼓
guv=箍
guw=古文
gux=贾
guy=诂
guz=孤
gv=贵
gva=鲑
gvb=皈
gvc=鬼才
gvd=龟
gve=刿
gvf=规
gvg=庋
gvh=规划
gvi=轨
gvj=诡计
gvk=匦
gvl=归
gvm=桂
gvn=妫
gvo=晷
gvp=鬼
gvq=规劝
gvr=刽
gvs=归宿
gvt=圭
gvu=硅
gvv=癸
gvw=瑰
gvx=跪下
gvy=诡
gvz=跪
gw=给
gwh=给回
gwi=给出
gwl=给了
gwq=给钱
gwr=给人
gws=给
gx=挂
gx=关系
gxb=寡
gxc=挂彩
gxd=挂断
gxf=括
gxg=挂钩
gxi=挂出
gxj=挂机
gxk=剐
gxl=挂了
gxm=栝
gxn=挂念
gxo=胍
gxp=瓜
gxq=刮
gxr=寡人
gxt=卦
gxu=挂上
gxv=挂着
gxx=挂心
gxy=诖
gxz=挂在
gy=滚
gya=鲧
gyb=棍棒
gyd=滚
gyg=滚滚
gyi=辊
gyk=滚开
gyl=滚轮
gym=棍
gyr=滚热
gys=绲
gyt=滚烫
gyu=磙
gyw=衮
gyy=滚圆
gyz=棍子
gz=够
gz=规则
gza=觏
gzb=勾
gzc=苟
gzd=沟
gze=岣
gzf=拘
gzg=鞲
gzh=够好
gzi=构成
gzj=钩
gzk=购
gzm=构
gzm=枸
gzn=媾
gzp=狗屁
gzq=狗
gzr=佝
gzs=缑
gzt=垢
gzu=彀
gzv=篝
gzw=购物
gzx=勾选
gzy=诟
gzz=遘
h=和
ha=哈
had=哈达
haf=哈佛
hah=哈哈
hai=蛤
haj=铪
hak=哈
ham=蛤蟆
haq=哈欠
har=哈日
hay=哈腰
hb=何必
hc=好
hca=好啊
hcb=皓
hcc=蒿
hcd=浩
hcd=濠
hce=好恶
hcf=耗费
hcg=好感
hch=好好
hci=蚝
hcj=镐
hck=号
hck=嗥
hcl=耗
hcm=号码
hcn=好难
hco=昊
hcp=好评
hcq=好奇
hcr=好人
hcs=好色
hct=郝
hcu=好事
hcv=貉
hcw=豪
hcx=好像
hcy=好友
hcz=好在
hd=还
hda=海岸
hdb=害
hdd=海
hde=海尔
hdf=海风
hdg=骸
hdh=还好
hdi=还差
hdj=海军
hdk=嗨
hdm=骇
hdn=还能
hdo=胲
hdp=害怕
hdq=氦
hdr=害人
hds=还算
hdt=海豚
hdu=还是
hdv=还真
hdw=亥
hdx=还想
hdy=醢
hdz=孩
he=何
hea=翮
hec=荷
hed=河
hed=涸
hef=何妨
heg=合格
heh=和
hei=蚵
hek=喝
hel=贺
hem=核
hen=河南
heo=曷
hep=禾
heq=禾
her=合
hes=纥
het=赫
heu=何时
hev=貉
hew=劾
hex=和谐
hey=诃
hez=合作
hf=很
hfa=很爱
hfb=痕
hfc=很惨
hfd=很多
hff=很烦
hfg=很高
hfh=很好
hfi=很长
hfj=很久
hfk=很快
hfl=很累
hfm=很忙
hfn=很难
hfq=狠
hfr=很热
hfs=很酸
hft=很痛
hfu=很少
hfv=很重
hfw=很晚
hfx=恨
hfy=很有
hfz=很早
hg=横
hgc=蘅
hgd=横渡
hgf=横幅
hgg=横贯
hgh=哼哼
hgi=衡
hgj=恒久
hgk=哼
hgl=衡量
hgm=桁
hgn=姮
hgp=横批
hgq=横切
hgs=横扫
hgt=横条
hgu=恒生
hgw=亨
hgx=恒
hgy=衡阳
hgz=横在
hh=行
hhb=航班
hhc=巷
hhd=夯
hhg=行规
hhh=行货
hhi=行
hhj=行家
hhk=吭
hhl=行列
hhm=杭
hhq=行情
hhs=绗
hht=航天
hhu=行数
hhv=航
hhw=颃
hhx=航线
hhy=行业
hi=好处
hj=含
hjb=寒
hjc=菡
hjd=汗
hjf=捍
hjg=邯
hjh=焊
hji=蚶
hjj=罕见
hjk=喊
hjl=函
hjm=阚
hjo=旱
hjq=犴
hjr=颔
hjs=寒酸
hju=韩
hjv=憨
hjw=捍卫
hjx=憾
hjy=酣
hjz=鼾
hk=坏
hkb=怀抱
hkd=淮
hkh=坏话
hki=徊
hkj=怀旧
hkl=坏了
hkm=槐
hkn=怀念
hkr=坏人
hks=坏死
hkt=坏
hku=坏事
hkv=怀中
hkx=怀
hky=怀疑
hkz=踝
hl=黄
hla=鳇
hlb=皇
hlc=荒
hld=湟
hle=隍
hlf=荒废
hlg=黄瓜
hlh=煌
hli=蝗
hlj=凰
hlk=惶恐
hln=黄牛
hlo=晃
hlq=黄雀
hlr=恍然
hls=黄色
hlt=荒唐
hlu=磺
hlv=簧
hlw=璜
hlx=慌
hlx=恍
hly=谎
hlz=遑
hm=后面
hn=湖南
ho=或
hob=豁
hoc=获
hod=活
hof=攉
hog=惑
hoh=和
hoi=蠖
hoj=镬
hoj=锪
hok=嚯
hol=耠
hom=豁免
hop=祸
hoq=获取
hor=货
hos=火速
hot=祸胎
hou=获胜
hov=活着
how=货物
hox=或许
hoy=霍
hoz=活在
hp=害怕
hq=回去
hr=换
hra=鲩
hrb=痪
hrc=萑
hrd=涣
hrd=奂
hrf=擐
hrg=还给
hrh=焕
hri=患
hrj=豢
hrk=唤
hrl=换了
hrm=桓
hrn=嬛
hrq=獾
hrr=环绕
hrs=缓
hrt=欢腾
hru=换上
hrv=还债
hrw=环
hrx=欢心
hry=欢
hrz=还
hs=红
hsb=宏
hsc=蕻
hsd=洪
hsd=泓
hsf=红粉
hsg=弘
hsh=烘
hsi=虹
hsj=红酒
hsk=哄
hsl=红利
hsm=闳
hsn=红娘
hsp=哄骗
hsq=宏碁
hsr=红人
hss=红色
hst=宏图
hsu=洪水
hsv=轰炸
hsw=宏伟
hsx=黉
hsy=讧
hsz=红枣
ht=后天
hu=户
hua=互
hub=湖北
huc=葫
hud=沪
hud=斛
hue=岵
huf=护
hug=弧
huh=虎
huh=烀
hui=蝴
huj=呼叫
huk=呼
hul=虍
hum=糊
hun=鹄
hup=乎
huq=狐
hur=忽然
hus=护送
hut=糊涂
huu=胡
huu=觳
huv=笏
huw=忽
hux=怙
huy=醐
hv=会
hva=惠
hvb=回报
hvc=荟
hvd=汇
hvd=浍
hve=堕
hvf=挥
hvg=麾
hvh=烩
hvh=秽
hvi=徽
hvj=毁
hvk=回
hvl=回来
hvm=桧
hvn=回暖
hvo=晦
hvq=回去
hvr=会
hvs=绘
hvs=缋
hvt=回头
hvu=灰
hvv=会展
hvw=珲
hvx=悔
hvy=讳
hvz=汇总
hw=黑
hwa=黑暗
hwb=黑白
hwd=黑洞
hwf=黑发
hwg=黑锅
hwh=嘿嘿
hwi=黑车
hwk=嘿
hwl=黑了
hwm=黑马
hwp=黑屏
hwr=黑人
hws=黑色
hwt=黑头
hwu=黑手
hww=黑窝
hwy=黑夜
hwz=黑字
hx=话
hxa=画
hxb=花瓣
hxc=花
hxd=滑
hxe=花儿
hxf=砉
hxg=划
hxh=花卉
hxj=铧
hxk=哗
hxm=桦
hxm=骅
hxn=华南
hxp=花瓶
hxq=猾
hxr=化
hxs=划算
hxt=话题
hxu=话说
hxv=花招
hxw=花纹
hxx=化学
hxy=花样
hxz=花在
hy=混
hya=昏暗
hyc=荤
hyd=浑
hye=魂
hyf=婚否
hyg=混个
hyh=混合
hyj=婚介
hyk=昏聩
hym=阍
hyn=婚
hyp=魂魄
hyq=婚庆
hyr=浑然
hys=婚俗
hyt=混同
hyu=昏
hyw=珲
hyy=诨
hyz=混杂
hz=后
hza=厚爱
hzb=瘊
hzd=厚道
hze=厚恩
hzf=后方
hzg=骺
hzh=后悔
hzi=厚
hzj=后劲
hzk=吼
hzl=后来
hzm=糇
hzn=后年
hzp=后
hzq=猴
hzr=候
hzs=后嗣
hzt=堠
hzu=后市
hzv=篌
hzw=厚望
hzx=鲎
hzy=后院
hzz=逅
i=出
ia=差
iab=察
iac=茶
iad=汊
iae=嵖
iaf=插
iag=茶馆
iah=插好
iai=查出
iaj=镲
iak=喳
ial=差了
iam=查
ian=姹
iap=衩
iaq=插曲
iar=插入
iat=插头
iau=碴
iav=查找
iaw=查问
iax=刹
iay=诧
iaz=插座
ib=成本
ic=超
icb=超薄
icc=炒菜
icd=潮
ice=超额
icf=抄
icg=超过
ich=炒
ici=超出
icj=钞
ick=吵
icl=耖
icm=超卖
icn=吵闹
ico=晁
icp=钞票
icq=超前
icr=超人
ics=绰
ict=超
icu=朝
icv=巢
icw=朝外
icx=怊
icy=超越
icz=炒作
id=拆
idb=瘥
idc=柴草
idd=拆掉
idf=拆分
idh=拆毁
idi=拆除
idj=钗
idk=拆开
idq=拆迁
idr=侪
ids=拆散
idt=拆台
idv=柴
idw=虿
idx=拆卸
idy=差
idz=拆字
ie=车
iea=车
ieb=撤兵
iec=车次
ied=澈
ief=撤
ieg=彻骨
ieh=车祸
iei=彻
iej=车间
iek=车库
iel=车辆
iem=车门
ien=车内
iep=掣
ies=车速
iet=坼
ieu=砗
iev=车站
iew=车位
iex=撤销
iey=彻夜
iez=车子
if=陈
ifa=尘埃
ifb=宸
ifc=陈醋
ifd=沉
ife=陈
iff=抻
ifg=晨光
ifh=称
ifi=辰
ifj=陈旧
ifk=臣
ifm=郴
ifn=沉溺
ifo=晨
ifp=衬
ifq=衬裙
ifr=伧
ifs=沉思
ift=趁
ifu=碜
ifv=龀
ifw=琛
ifx=尘
ify=谶
ifz=趁早
ig=成
igb=承包
igc=成才
igd=澄
igf=撑
igg=成功
igh=称
igi=惩
igj=铖
igk=呈
igl=丞
igm=橙
ign=承诺
igo=瞠
igp=裎
igq=乘
igr=承认
igs=橙色
igt=城
igu=城市
igv=承
igw=琤
igx=承销
igy=诚
igz=逞
ih=长
iha=厂
ihb=常备
ihc=苌
ihd=场地
ihe=嫦娥
ihf=长发
ihg=常规
ihh=场合
ihi=徜
ihj=常见
ihk=唱
ihl=常来
ihm=阊
ihn=嫦
iho=肠
ihp=长篇
ihq=猖
ihr=偿
ihs=场所
iht=场
ihu=畅
ihv=厂长
ihw=肠胃
ihx=常
ihx=氅
ihy=昶
ihz=长足
ii=吃
iia=豉
iib=痴
iic=茌
iid=池
iid=鸱
iie=耻
iif=持
iig=弛
iih=炽
iii=迟
iij=持久
iik=嗤
iil=迟了
iim=驰
iin=媸
iio=匙
iip=斥
iiq=痴情
iir=侈
iis=吃素
iit=赤
iiu=尺
iiv=齿
iiv=蚩
iiw=啻
iiy=持有
iiz=迟
ij=产
ijb=单
ijc=蒇
ijd=潺
ijf=搀
ijg=廛
ijh=掺和
iji=蝉
ijj=铲
ijm=阐
ijn=婵
ijp=禅
ijq=产权
ijr=缠绕
ijs=缠
iju=馋
ijv=缠着
ijw=颤
ijx=忏
ijy=谗
ijy=谄
ijz=躔
ik=揣
ikc=揣测
ikf=搋
ikk=啜
ikm=揣摩
iko=膪
ikz=踹
il=窗
ilb=疮
ild=闯荡
ilg=床
ilh=窗户
ilj=幢
ilk=窗口
ilm=闯
ilr=创
ilt=床头
ilu=创伤
ilv=创制
ilw=窗外
ilx=怆
ily=创意
ilz=创造
im=重码
in=承诺
io=戳
iob=辍笔
ioh=绰号
ioi=辍
ioj=戳记
iok=啜
ion=婥
iop=戳破
ioq=啜泣
ior=戳入
ios=绰
iov=龊
iox=戳
ioz=踔
ip=产品
iq=重启
ir=传
irb=穿
irc=川菜
ird=传达
irf=船夫
irg=穿过
irh=穿好
iri=传出
irj=钏
irk=喘
irl=串
irm=椽
irp=川
irq=氚
irr=传染
irs=传送
irt=传统
iru=传说
irv=船
irw=传闻
irx=舛
iry=传言
irz=遄
is=冲
isa=宠爱
isb=宠
isc=茺
isd=冲动
ise=崇
isf=舂
isg=冲高
ish=重回
isi=重重
isj=铳
isk=冲垮
isl=虫
ism=充满
isp=重
isq=重庆
isr=冲入
iss=重塑
ist=冲突
isu=充实
isv=虫
isw=充
isx=憧
isy=充裕
isz=重组
it=传统
iu=处
iua=亍
iub=初步
iuc=储存
iud=触
iue=除
iuf=搐
iug=出国
iuh=黜
iui=厨
iui=蜍
iuj=锄
iuk=贮
iul=处理
ium=楚
ium=楮
iun=处女
iup=初
iuq=出去
iur=储
ius=绌
iut=出头
iuu=础
iuv=出
iuw=畜
iux=怵
iuy=处于
iuz=躇
iv=吹
iva=垂爱
ivd=垂钓
ive=陲
ivf=捶
ivg=吹干
ivh=炊
ivj=锤
ivk=吹
ivl=吹了
ivm=椎
ivn=吹牛
ivp=垂
ivq=垂青
ivs=垂死
ivt=垂头
ivu=垂首
ivv=垂直
ivw=垂危
ivx=垂询
ivy=炊烟
ivz=吹奏
iw=成为
ix=出现
iy=纯
iyb=纯白
iyc=莼
iyd=淳
iyf=春
iyg=春光
iyh=春花
iyi=唇
iyj=春节
iyl=春联
iym=椿
iyp=淳朴
iyq=春秋
iyr=蠢人
iys=纯
iyt=春天
iyu=纯属
iyv=纯真
iyw=鹑
iyx=春夏
iyy=醇
iz=抽
izb=瘳
izc=筹措
izd=抽调
ize=丑恶
izf=抽
izh=愁
izi=抽出
izj=帱
izk=抽空
izl=丑陋
izm=筹码
izn=丑女
izo=瞅
izp=臭屁
izq=抽签
izr=仇
izr=雠
izs=绸
izt=畴
izu=抽身
izv=丑
izw=丑闻
izx=惆
izy=酬
izz=臭
j=就
ja=骄傲
jb=进
jbb=进步
jbc=荩
jbd=津
jbe=金额
jbf=谨防
jbg=靳
jbh=烬
jbi=尽
jbj=锦
jbk=噤
jbk=赆
jbl=紧
jbl=巾
jbm=禁
jbn=妗
jbp=斤
jbr=金
jbs=缙
jbs=矜
jbt=尽头
jbu=馑
jbv=劲
jbw=瑾
jbx=进行
jby=谨
jbz=近
jc=精彩
jd=简单
je=金额
jf=解放
jg=结果
jh=几乎
ji=几
jia=击
jib=寄
jic=藉
jic=芰
jid=急
jid=奇
jie=际
jie=觊
jif=挤
jig=即
jih=稽
jih=嵇
jii=辑
jij=忌
jik=唧
jil=冀
jil=乩
jim=机
jim=骥
jin=嫉
jio=肌
jip=及
jip=系
jiq=基
jir=集
jis=级
jis=继
jit=圾
jiu=吉
jiu=戟
jiv=己
jiv=笈
jiw=剂
jiw=玑
jix=悸
jiy=记
jiy=计
jiz=迹
jj=解决
jk=经
jka=井
jkb=痉
jkc=敬
jkc=荆
jkd=净
jke=阱
jkf=静
jkg=弪
jkh=精华
jki=径
jkj=镜
jkk=惊恐
jkl=竟
jkl=靖
jkm=精
jkn=婧
jko=晶
jko=腈
jkp=精品
jkq=獍
jkr=儆
jks=经
jkt=境
jku=兢
jkv=劲
jkw=京
jkx=惊
jkx=憬
jky=精英
jkz=迳
jl=将
jla=豇
jlc=蒋
jld=江
jle=降
jlg=疆
jlh=江湖
jli=奖惩
jlj=将近
jlk=匠
jll=耩
jlm=糨
jln=江南
jlp=奖品
jlq=将其
jlr=僵
jls=缰
jlt=讲台
jlu=礓
jlx=江西
jly=讲
jlz=将在
jm=间
jma=柬
jmb=兼
jmb=煎
jmc=荐
jmd=减
jmd=渐
jmf=捡
jmg=鞯
jmh=肩
jmi=建成
jmj=键
jmk=见
jml=坚
jmm=检
jmm=槛
jmn=奸
jmo=腱
jmp=裥
jmr=件
jmr=僭
jms=缄
jmt=检讨
jmu=碱
jmv=简
jmv=笕
jmw=见闻
jmx=尖
jmy=谏
jmy=戬
jmz=建
jn=叫
jna=鲛
jnb=窖
jnb=敫
jnc=蕉
jnd=角
jne=峤
jnf=搅
jng=浇灌
jnh=叫唤
jni=较
jnj=铰
jnk=嚼
jnl=教
jnm=骄
jnn=娇
jno=脚
jnq=狡
jnr=焦
jnr=僬
jns=缴
jnt=交通
jnu=礁
jnv=剿
jnw=交
jnx=觉
jny=酵
jny=醮
jnz=跤
jo=奇偶
jp=接
jpa=鲒
jpb=皆
jpc=节
jpd=洁
jpe=阶
jpf=揭
jpg=戒
jpg=骱
jph=秸
jpi=街
jpj=捷径
jpk=嗟
jpl=竭
jpm=杰
jpn=姐
jpo=睫
jpp=截屏
jpq=借钱
jpr=借
jpr=价
jps=结
jpt=界
jpu=截
jpv=孑
jpw=解围
jpx=桀
jpy=诫
jpy=诘
jpz=节奏
jq=久
jqa=鬏
jqb=究
jqb=疚
jqc=就此
jqd=酒
jqf=揪
jqg=酒鬼
jqh=就会
jqi=厩
jqj=舅
jqk=啾
jql=旧
jqm=阄
jqn=就能
jqp=九
jqq=救
jqr=酒肉
jqs=纠
jqt=赳
jqu=就是
jqv=纠正
jqw=玖
jqy=就业
jqz=救灾
jr=卷
jrb=蠲
jrd=涓
jrf=捐
jrg=眷顾
jri=卷尺
jrj=镌
jrj=锩
jrk=鹃
jrl=眷恋
jrm=卷毛
jrn=娟
jrq=狷
jrr=倦
jrs=绢
jru=卷舌
jrv=捐助
jrw=捐物
jrx=惓
jrz=捐赠
js=窘
jsb=窘
jsh=炯
jsk=囧
jso=炅
jsp=窘迫
jsr=迥然
jst=窘态
jsx=窘相
jsy=迥异
jsz=迥
jt=今天
jtc=蕨
jtd=决
jte=崛
jtf=掘
jth=爝
jti=厥
jtj=镢
jtk=嚼
jtl=决裂
jtm=橛
jto=矍
jtp=爵
jtq=獗
jtr=倔
jts=绝
jtt=掘土
jtu=决胜
jtv=孓
jtw=玦
jtx=觉
jty=诀
jtz=蹶
ju=据
jua=车
jub=句
juc=菊
juc=苣
jud=沮
jue=聚
jue=鄹
juf=拒
jug=鞠
juh=炬
juj=锯
juj=飓
juk=巨
jul=且
jum=橘
jum=驹
jun=犋
juo=瞿
jup=裾
juq=具
jus=沮丧
jut=趄
juu=局
juv=龃
juw=琚
jux=举
jux=惧
juy=醵
juz=距
juz=遽
jv=简直
jw=几位
jx=加
jxa=夹
jxb=家
jxc=荚
jxd=浃
jxe=岬
jxf=挟
jxg=价格
jxh=稼
jxi=蛱
jxj=钾
jxj=镓
jxk=加快
jxl=架
jxm=枷
jxn=嫁
jxo=胛
jxp=袷
jxq=加强
jxr=假
jxt=家庭
jxu=嘉
jxv=笳
jxw=珈
jxx=贾
jxz=迦
jy=均
jyb=军
jyc=菌
jyd=龟
jye=峻
jyf=捃
jyg=麇
jyh=均衡
jyi=君臣
jyj=钧
jyk=均可
jyl=竣
jym=骏
jyn=均能
jyr=俊
jyt=均
jyu=军事
jyv=筠
jyw=珺
jyx=均线
jyy=君
jz=节奏
k=可
ka=卡
kaf=咖啡
kah=卡号
kai=卡车
kak=咖
kak=咯
kal=卡拉
kao=胩
kap=卡片
kar=佧
kat=卡通
kau=卡
kb=恐怖
kc=靠
kca=靠岸
kcb=拷贝
kcd=考点
kcf=拷
kcg=考古
kch=烤
kci=考察
kcj=铐
kck=考考
kcl=考
kcm=栲
kcn=犒
kcp=考评
kcq=考勤
kcr=考入
kct=考题
kcu=尻
kcv=考证
kcw=考完
kcx=烤箱
kcy=考验
kcz=靠在
kd=开
kda=开
kdc=蒈
kde=凯
kdf=揩
kdh=开会
kdk=开口
kdl=开了
kdm=楷
kdp=开盘
kdr=慨然
kds=开赛
kdt=垲
kdu=开始
kdw=开往
kdx=慨
kdy=开业
kdz=开凿
ke=克
kea=可爱
keb=客
kec=苛
ked=渴
kee=岢
kef=克服
keg=颗
keh=科
kei=轲
kej=钶
kej=铪
kek=咳
kel=可怜
kem=棵
ken=可能
keo=瞌
kep=可怕
keq=氪
ker=客人
kes=缂
ket=坷
keu=壳
kev=克制
kew=刻
kex=恪
key=课
kez=苛责
kf=肯
kfd=肯定
kfg=恳
kfh=垦荒
kfk=啃
kfp=裉
kfq=恳求
kft=恳谈
kfv=龈
kfw=肯为
kg=坑
kgd=坑道
kgh=坑害
kgi=吭哧
kgj=铿
kgk=吭
kgm=坑蒙
kgp=坑骗
kgq=铿锵
kgr=坑人
kgt=坑
kgu=吭声
kgw=坑洼
kh=抗
kha=抗癌
khd=抗跌
khf=扛
khg=康
khh=炕
khj=钪
khk=慷慨
khl=伉俪
khm=糠
khq=扛起
khr=伉
khs=抗诉
kht=抗体
khv=抗战
khw=亢
khx=慷
khy=抗议
khz=抗灾
ki=看出
kj=看
kjb=看报
kjc=莰
kjd=看到
kjf=看法
kjg=刊
kjh=看好
kji=堪称
kjj=看见
kjk=看看
kjl=看来
kjm=槛
kjo=瞰
kjp=看破
kjq=勘
kjr=侃
kjs=看似
kjt=坎
kju=砍
kjv=看着
kjw=看望
kjx=看下
kjy=堪忧
kjz=看在
kk=快
kkb=快报
kkc=蒯
kkd=浍
kkg=快感
kkh=快活
kki=快车
kkj=快捷
kkk=哙
kkl=快乐
kkm=快慢
kko=脍
kkp=快跑
kkq=狯
kkr=会
kks=快速
kkt=块
kku=快说
kkv=筷
kkw=快慰
kky=快要
kkz=快走
kl=况
kla=狂傲
klb=狂奔
klc=矿藏
kld=夼
klf=狂风
klg=邝
klh=狂欢
kli=狂潮
klk=匡
klk=贶
kll=狂乱
klm=框
klo=旷
klp=诓骗
klq=狂
klr=狂热
kls=纩
klt=圹
klu=矿
klv=筐
klw=狂妄
klx=狂笑
kly=诳
klz=狂躁
km=昆明
kn=可能
kn=困难
ko=扩
kob=阔别
kod=扩大
kof=括
kog=廓
koh=括号
koi=蛞
koj=扩建
kol=阔佬
kom=阔
koq=阔气
kor=扩容
kos=扩散
kou=阔少
kov=扩展
kp=恐怕
kq=况且
kr=宽
krb=宽
krd=宽带
kre=款额
krf=宽幅
krg=髋
krh=宽厚
kri=宽敞
krk=宽阔
krl=宽了
krp=宽屏
krr=宽容
krs=宽松
kru=款
krv=宽窄
krw=宽慰
krx=款项
kry=宽裕
ks=空
ksb=空白
ksc=空仓
ksd=空洞
kse=崆
ksf=控
ksg=恐
ksh=恐慌
ksj=空间
ksk=空空
ksl=空了
ksm=空门
ksn=空难
ksp=恐怕
ksq=空缺
ksr=倥
kss=控诉
kst=空头
ksu=空手
ksv=箜
ksw=空位
ksy=空运
ksz=孔
kt=开通
ku=酷
kua=酷爱
kub=窟
kuc=苦
kud=刳
kuf=库房
kug=库
kuh=哭喊
kuj=枯竭
kuk=哭
kul=哭了
kum=枯
kun=苦恼
kup=裤
kur=酷热
kus=绔
kut=堀
kuu=哭声
kuv=苦衷
kuw=枯萎
kux=喾
kuy=酷
kuz=枯燥
kv=亏
kvb=窥
kvc=葵
kvd=溃
kve=岿
kvf=揆
kvg=魁
kvh=葵花
kvi=蝰
kvj=馗
kvk=匮
kvl=亏了
kvo=睽
kvp=窥破
kvq=亏钱
kvr=傀
kvs=亏损
kvt=溃逃
kvu=盔
kvv=篑
kvw=魁梧
kvx=愧
kvy=溃疡
kvz=逵
kw=尅
kwu=剋
kx=夸
kxb=挎包
kxd=夸
kxf=挎
kxg=跨过
kxh=跨行
kxj=夸奖
kxk=夸口
kxn=跨年
kxo=胯
kxp=跨排
kxr=侉
kxt=垮
kxu=跨省
kxv=夸张
kxy=跨越
kxz=跨
ky=困
kya=鲲
kyb=捆绑
kyd=困顿
kye=崑
kyf=捆
kyh=焜
kyj=锟
kyk=困
kyl=困了
kym=阃
kyn=困难
kyo=昆
kyp=鲲鹏
kyq=昆曲
kyr=困扰
kys=困死
kyt=坤
kyv=困住
kyw=琨
kyx=悃
kyy=醌
kz=口
kza=口岸
kzb=寇
kzc=蔻
kzd=口袋
kzf=扣
kzg=口感
kzh=口号
kzi=扣除
kzj=口径
kzk=叩
kzl=口令
kzm=抠门
kzn=口内
kzo=眍
kzq=口气
kzr=扣肉
kzs=口算
kzt=口头
kzu=口水
kzv=筘
kzw=口味
kzx=口信
kzy=口语
kzz=扣子
l=了
la=拉
lab=瘌
lac=落
lad=拉倒
laf=拉
lag=拉高
lah=拉回
lai=蜡
laj=垃圾
lak=啦
lak=喇
lal=辣
lam=喇嘛
lao=腊
lap=拉票
laq=拉起
lar=腊肉
las=拉萨
lat=垃
lau=剌
lav=拉着
law=辣味
lax=落下
lay=腊月
laz=邋
lb=林
lba=鳞
lbc=蔺
lbd=淋
lbe=嶙
lbf=拎
lbg=麟
lbi=辚
lbk=啉
lbl=临
lbm=粼
lbo=瞵
lbp=鳞片
lbr=邻
lbs=吝啬
lbu=磷
lbw=琳
lby=霖
lbz=躏
lc=老
lcb=牢
lcc=劳
lcd=涝
lce=崂
lcf=捞
lcg=老公
lch=烙
lci=老成
lcj=铑
lck=唠
lcl=耢
lcm=栳
lcn=姥
lcp=老婆
lcq=老区
lcr=佬
lcs=络
lct=老头
lcu=老实
lcv=老者
lcx=老兄
lcy=酪
lcz=老早
ld=来
lda=来
ldb=癞
ldc=莱
ldd=濑
lde=崃
ldg=来个
ldh=来回
ldi=徕
ldj=铼
ldl=来了
ldn=来年
ldo=睐
ldp=赖皮
ldq=来去
ldt=来头
ldu=赖
ldv=籁
ldw=来往
ldz=来自
le=乐
lea=鳓
led=泐
leg=勒
lek=嘞
lel=勒令
leo=肋
lep=乐
leq=乐趣
ler=仂
les=勒索
let=乐土
leu=乐事
lev=了
ley=乐园
lez=乐子
lf=浪费
lg=冷
lga=冷傲
lgc=冷藏
lgd=冷
lgf=冷风
lgg=冷宫
lgh=冷汗
lgi=冷场
lgj=冷静
lgk=冷酷
lgl=冷了
lgm=楞
lgn=冷暖
lgp=冷僻
lgq=冷清
lgs=冷色
lgt=塄
lgu=冷水
lgx=愣
lh=浪
lhb=狼狈
lhc=莨
lhd=朗
lhf=浪费
lhg=廊
lhh=稂
lhi=螂
lhj=锒
lhk=啷
lhm=榔
lhq=狼
lhs=朗诵
lht=浪涛
lhv=郎中
lhw=琅
lhz=浪子
li=里
lia=丽
lib=痢
lic=莉
lic=荔
lid=漓
lif=立法
lig=理工
lih=利
lii=历
lii=厘
lij=锂
lik=哩
lil=鹂
lil=郦
lim=李
lim=骊
lin=娌
lip=礼
liq=狸
lir=例
lir=俚
lis=罹
lit=坜
liu=砾
liv=力
liv=蠡
liw=离
liw=璃
lix=栗
liy=雳
liz=逦
lj=了解
ljb=兰
ljc=蓝
ljd=滥
ljd=漤
lje=岚
ljf=拦
ljg=栏杆
ljh=烂
ljj=镧
ljl=览
ljm=栏
ljn=烂泥
ljp=褴
ljr=懒人
ljs=缆
ljt=蓝天
ljv=篮
ljw=斓
ljx=懒
ljy=谰
ljz=篮子
lk=另
lka=鲮
lkb=领班
lkc=菱
lkd=凌
lkd=泠
lke=岭
lkf=零分
lkg=灵感
lkh=灵活
lki=蛉
lkj=铃
lkk=囹
lkk=呤
lkl=另类
lkm=棱
lkn=岭南
lko=〇
lkr=令
lks=绫
lkt=聆听
lku=铃声
lkv=龄
lkw=玲
lkx=领先
lky=零
lky=羚
ll=两
lla=两
llb=两边
llc=莨
lld=梁
lld=粱
llf=靓
llg=魉
llh=良好
lli=辆
llj=两句
llk=凉快
llm=粮
lln=两年
llo=量
llp=两旁
llr=俩
lls=亮色
llt=墚
llv=两种
llw=亮
llx=良心
lly=谅
llz=踉
lm=连
lma=鲢
lmb=帘
lmc=莲
lmd=涟
lmd=殓
lme=联
lmf=联防
lmg=廉
lmh=炼
lmi=蠊
lmj=链
lmk=脸孔
lml=联络
lmm=楝
lmn=连年
lmo=脸
lmp=裢
lmq=恋情
lmr=敛
lms=练
lmt=联通
lmw=恋
lmx=怜
lmy=连夜
lmz=连
ln=料
lna=鹩
lnb=疗
lnc=蓼
lnd=潦
lne=聊
lnf=撩
lng=廖
lnh=燎
lni=疗程
lnj=镣
lnk=嘹
lnl=料理
lnm=料
lnn=辽宁
lno=瞭
lnq=獠
lnr=僚
lns=缭
lnt=聊天
lnu=尥
lnv=了
lnw=瞭望
lnx=疗效
lny=疗养
lnz=辽
lo=落
lob=瘰
loc=萝
lod=洛
lof=摞
log=锣鼓
loh=烙
loi=螺
loj=锣
lok=咯
lol=裸露
lom=骡
lon=落难
loo=脶
lop=裸
loq=猡
lor=倮
los=罗
lot=裸体
lou=硌
lov=箩
low=蠃
low=雒
lox=螺旋
loy=洛阳
loz=逻
lp=列
lpa=鬣
lpb=列表
lpd=烈
lpf=捩
lpg=猎狗
lph=烈火
lpi=列出
lpj=列举
lpk=咧
lpn=烈女
lpq=猎
lpr=列入
lpt=趔
lpu=劣
lpv=劣质
lpw=猎物
lpx=列席
lpy=烈焰
lpz=躐
lq=刘
lqb=瘤
lqc=留存
lqd=流
lqe=陆
lqf=旒
lqg=留给
lqh=熘
lqi=流程
lqj=镏
lqk=留空
lql=浏览
lqm=柳
lqm=骝
lqn=留念
lqp=留
lqq=六千
lqr=流入
lqs=绺
lqt=流通
lqu=硫
lqv=留着
lqw=六
lqx=鹨
lqy=留言
lqz=遛
lr=乱
lrc=乱窜
lrd=滦
lrf=乱发
lrg=乱搞
lrh=乱花
lri=卵巢
lrm=乱码
lrp=卵
lrq=乱
lrt=乱套
lru=乱说
lrv=乱转
lrw=鸾
lrx=乱想
lry=乱用
lrz=卵子
ls=龙
lsb=窿
lsc=茏
lsd=泷
lse=隆
lsf=拢
lsh=龙虎
lsj=龙井
lsk=咙
lsl=聋
lsm=栊
lso=胧
lsq=隆起
lst=垅
lsu=龙
lsv=笼
lsw=弄
lsx=龙虾
lsy=聋哑
lsz=聋子
lt=论坛
ltf=掠
ltj=锊
ltl=略略
ltt=略
lu=路
lua=鲁

luc=芦
lud=泸
lue=陆
luf=掳
lug=鹿
luh=炉
lui=轳
luj=镥
luk=赂
lul=卢
lum=橹
lun=颅内
luo=胪
lup=禄
luq=录取
lus=绿
lut=垆
luu=碌
luv=录
luv=舻
luw=璐
lux=戮
luy=露
luz=鹭
lv=率
lvc=屡次
lvd=滤
lvf=旅
lvg=旅馆
lvh=虑
lvi=律
lvj=铝
lvk=吕
lvl=屡屡
lvm=驴
lvp=褛
lvq=氯
lvr=侣
lvs=绿
lvt=旅途
lvu=屡
lvv=绿洲
lvw=率
lvx=履行
lvy=旅游
lw=类
lwa=耒
lwb=类别
lwc=蕾
lwd=泪
lwf=擂
lwg=勒
lwh=泪痕
lwi=雷池
lwj=镭
lwk=嘞
lwl=累了
lwm=檑
lwn=嫘
lwo=肋
lwp=雷劈
lwq=垒球
lwr=儡
lws=垒
lwt=累
lwu=磊
lwv=累赘
lww=羸
lwx=类型
lwy=雷
lx=联系
lxr=俩
ly=论
lyd=沦
lyf=抡
lyh=轮换
lyi=轮
lyk=囵
lyl=沦落
lyr=伦
lys=纶
lyv=论证
lyw=论文
lyx=沦陷
lz=楼
lza=剅
lzb=瘘
lzc=蒌
lzd=漏
lze=陋
lzf=搂
lzg=髅
lzi=蝼
lzj=镂
lzk=喽
lzl=耧
lzm=娄
lzp=楼盘
lzq=漏气
lzr=偻
lzt=楼梯
lzu=楼上
lzv=篓
lzw=漏网
lzx=楼下
lzy=露
m=没
ma=吗
maa=马鞍
mab=麻痹
mad=马达
maf=抹
mag=麻
mah=马虎
mai=蚂
maj=麻将
mak=嘛
mal=马路
mam=杩
man=妈
map=祃
maq=犸
mar=骂人
mat=码头
mau=码
mav=马
maw=玛
max=马戏
may=蚂蚁
maz=孖
mb=民
mbb=民办
mbc=苠
mbd=泯
mbe=岷
mbf=抿
mbg=敏感
mbh=民航
mbj=民间
mbk=黾
mbl=皿
mbm=闽
mbn=闽南
mbo=旻
mbp=敏
mbr=敏锐
mbs=缗
mbw=玟
mbx=悯
mbz=民族
mc=毛
mca=髦
mcb=毛病
mcc=茂
mcd=泖
mce=峁
mcf=旄
mch=冒汗
mci=冒充
mcj=帽
mck=冒
mcl=耄
mcm=懋
mcn=牦
mco=冒
mcp=贸
mcq=猫
mcr=贸然
mcs=矛
mcs=蝥
mct=矛头
mcu=冇
mcv=貌
mcw=袤
mcx=冒险
mcy=贸易
mcz=帽子
md=买
mdb=迈步
mdc=荬
mdf=麦
mdg=卖给
mdi=卖出
mdj=卖家
mdk=麦克
mdn=卖弄
mdo=脉
mdp=卖票
mdq=卖钱
mdr=买入
mds=麦穗
mdt=埋
mdu=卖
mdv=卖主
mdw=劢
mdy=霾
mdz=迈
me=么
meg=麽
mep=么
mf=们
mfb=门边
mfd=门
mff=扪
mfh=焖
mfj=钔
mfk=门口
mfl=门类
mfm=闷
mfp=门票
mfq=门前
mfr=门人
mfs=门锁
mfu=门市
mfx=悗
mg=梦
mgb=蒙蔽
mgc=萌
mgd=猛地
mgg=蒙古
mgh=梦幻
mgi=蜢
mgj=锰
mgl=猛烈
mgm=檬
mgn=猛男
mgo=盟
mgp=蒙骗
mgq=猛
mgt=蒙头
mgu=礞
mgv=艋
mgw=氓
mgx=懵
mh=忙
mhc=茫
mhd=漭
mhg=芒果
mhh=忙活
mhi=蟒
mhj=铓
mhm=盲目
mhr=茫然
mhu=硭
mhv=忙着
mhw=盲
mhx=忙
mi=米
mib=密
mic=蘼
mid=泌
mif=蜜蜂
mig=弥
mig=麋
mih=秘
mij=密集
mik=咪
mil=芈
mim=敉
min=迷你
mio=眯
mip=觅
miq=猕
mir=迷人
mis=米色
mit=谜团
miu=迷上
miv=迷住
miw=迷雾
miy=谜
miz=迷
mj=慢
mja=鳗
mjb=漫步
mjc=蔓
mjd=满
mjf=满分
mjg=鞔
mjh=熳
mji=螨
mjj=幔
mjk=满口
mjm=慢慢
mjn=嫚
mjo=瞒
mjq=满腔
mjs=缦
mjt=墁
mju=馒
mjv=瞒着
mjw=蛮
mjx=悗
mjy=谩
mjz=满足
mk=名
mkb=冥
mkc=茗
mkd=溟
mke=名额
mkg=名贵
mkh=名画
mki=螟
mkj=铭
mkk=鸣
mkl=命令
mkm=明明
mkn=明年
mko=明
mkp=名片
mkq=明确
mkr=命
mkt=明天
mku=名师
mkv=明知
mkw=名为
mkx=名
mky=酩
mkz=名字
ml=美丽
mm=面
mma=面
mmb=面包
mmd=免
mmd=沔
mme=面额
mmf=免费
mmg=绵亘
mmj=面积
mmk=黾
mmm=棉
mmn=娩
mmo=眠
mmo=眄
mmp=面庞
mmq=面前
mmr=面容
mms=绵
mmt=腼腆
mmu=面试
mmw=面无
mmz=面子
mn=秒
mnb=秒表
mnc=苗
mnd=渺
mnf=描
mng=庙
mni=妙处
mnj=妙计
mnk=喵
mnm=杪
mnn=妙
mno=瞄
mnp=苗圃
mnq=妙趣
mns=缈
mnt=苗条
mnu=淼
mnv=瞄准
mnw=妙文
mnx=描写
mny=妙语
mnz=邈
mo=末
moa=无
mob=寞
mob=瘼
moc=莫
moc=蘑
mod=漠
moe=陌
mof=摸
mog=磨
mog=摩
moh=墨
moi=摸出
moj=镆
mok=嘿
mol=耱
mom=模
mon=嬷
moo=膜
mop=么
moq=默契
mor=默认
mos=摸索
mot=模特
mou=馍
mov=貊
mow=末位
mox=模型
moy=谟
mp=灭
mpa=灭
mpc=蔑
mpd=灭顶
mpi=蠛
mpj=灭绝
mpk=咩
mpm=灭门
mpu=蔑视
mpv=篾
mpw=灭亡
mpz=灭族
mq=目前
mql=谬论
mqs=缪
mqw=谬误
mqy=谬
mr=默认
ms=貌似
mt=明天
mu=目
mua=木
mub=目标
muc=幕
muc=苜
mud=沐
mue=木耳
muf=拇
mug=目光
muh=穆
mui=牧场
muj=钼
muk=呒
mul=目录
mum=模
mun=姆
muo=睦
mup=木牌
muq=目前
mur=仫
mus=牟
mut=坶
muu=木
muv=母
muw=亩
mux=母校
muy=霂
muz=母子
mv=忙着
mw=每
mwb=寐
mwc=莓
mwd=没
mwe=嵋
mwf=没法
mwg=魅
mwh=煤
mwi=美钞
mwj=镁
mwk=槑
mwl=美丽
mwm=梅
mwm=枚
mwn=妹
mwn=媒
mwo=昧
mwp=袂
mwq=猸
mwr=每人
mws=美色
mwt=每天
mwu=没事
mwv=眉
mww=玫
mwx=没戏
mwy=霉
mwz=妹子
mx=明显
my=没有
mz=某
mzb=某部
mzc=某次
mzf=谋反
mzg=某
mzh=谋划
mzi=蛑
mzj=某件
mzk=哞
mzl=谋略
mzm=某某
mzn=某年
mzo=眸
mzq=谋求
mzr=侔
mzs=牟
mzt=某天
mzu=谋杀
mzv=某种
mzw=某位
mzx=某些
mzy=谋
n=你
na=那
nab=哪边
nac=哪次
nad=哪点
nae=哪儿
naf=捺
nag=哪个
nah=那好
nai=拿出
naj=钠
nak=哪
nal=哪里
nam=那么
nan=娜
nao=肭
nap=衲
naq=拿起
nar=拿
nas=纳
nat=哪天
nau=南
nav=哪种
naw=哪位
nax=哪些
nay=哪样
naz=拿走
nb=您
nbr=您
nc=闹
ncb=孬
ncc=脑残
ncd=淖
ncf=挠
ncg=闹鬼
nch=脑海
nci=蛲
ncj=铙
nck=呶
ncl=闹铃
ncm=桡
ncn=恼怒
nco=脑
ncq=猱
ncr=恼人
ncs=脑髓
nct=垴
ncu=硇
ncv=闹钟
ncw=瑙
ncx=恼
ncy=挠痒
ncz=脑子
nd=难道
ndc=萘
ndd=奈
nde=耐
ndf=奶粉
ndh=奈何
ndj=耐久
ndk=耐看
ndl=耐力
ndm=柰
ndn=奶
ndq=氖
ndr=佴
ndt=奶糖
ndv=乃
ndx=耐心
ndy=耐用
ndz=奶嘴
ne=呢
nek=呐
nev=哪吒
ney=讷
nf=嫩
nfb=嫩白
nfc=嫩草
nfl=嫩绿
nfn=嫩
nfr=恁
ng=能
ngd=能动
ngf=能否
ngg=能够
ngh=能耗
ngl=能力
ngn=能耐
ngr=能人
ngs=能
ngu=能使
ngx=能行
ngy=能源
nh=囊
nha=囊
nhf=攮
nhk=囔
nho=曩
nhv=囊肿
ni=泥
nia=鲵
nid=溺
nif=拟
nig=尼姑
nih=你好
nii=昵称
nij=铌
nik=匿
nim=你们
nin=妮
nio=腻
nip=祢
niq=猊
nir=倪
nit=坭
niu=尼
niv=逆转
nix=怩
niy=霓
niz=逆
nj=难
nja=南
njb=南北
njd=难道
nje=男儿
njf=南方
njg=难怪
njh=男孩
nji=蝻
njk=喃
njm=楠
njn=南宁
njo=腩
njp=男排
njq=难求
njr=男人
njt=男
nju=南
njw=难忘
njx=男性
nk=宁
nkb=宁
nkc=苎
nkd=凝
nke=聍
nkf=拧
nkg=凝固
nkj=凝聚
nkk=咛
nkl=凝练
nkm=柠
nkq=狞
nkr=佞
nku=凝视
nkv=凝重
nkw=凝望
nkx=宁夏
nky=宁愿
nl=娘
nli=酿成
nlj=娘家
nlm=娘们
nln=娘
nlq=娘亲
nlt=娘胎
nlv=酿制
nly=酿
nlz=娘子
nm=年
nma=廿
nmb=年报
nmc=蔫
nmd=年度
nmf=撵
nmh=黏
nmi=辗
nmj=年级
nml=年龄
nmm=粘
nmn=年内
nmp=年
nmq=年轻
nmr=念
nms=念诵
nmt=埝
nmu=碾
nmy=年月
nn=鸟
nnb=尿布
nnc=茑
nnd=溺
nne=鸟儿
nni=鸟巢
nnk=鸟瞰
nnl=鸟类
nnm=鸟鸣
nnn=尿尿
nno=脲
nnp=袅
nnr=鸟人
nns=尿素
nnt=嬲
nnu=尿
nnw=鸟
nny=鸟语
no=挪
nod=挪动
nof=挪
noi=挪出
noj=锘
nok=喏
nom=糯
non=娜
nor=傩
nox=懦
noy=诺
np=捏
npc=孽
npd=涅
npe=聂
npf=捏
npg=孽根
nph=捏合
npi=捏成
npj=镊
npk=啮
npp=涅槃
nps=捏碎
npv=乜
npz=蹑
nq=牛
nqb=牛逼
nqd=纽带
nqe=牛耳
nqf=扭
nqg=牛股
nqi=牛车
nqj=钮
nqk=扭亏
nql=牛郎
nqm=牛马
nqn=妞
nqp=牛皮
nqq=狃
nqs=纽
nqt=扭头
nqu=牛市
nqv=扭转
nqx=忸
nqy=纽约
nqz=牛仔
nr=暖
nrd=暖冬
nrf=暖风
nrl=暖流
nrn=暖暖
nro=暖
nrp=暖瓶
nrq=暖气
nrs=暖色
nry=暖意
ns=弄
nsc=农村
nsd=农
nsf=农妇
nsh=秾
nsk=哝
nsl=农历
nsm=农民
nso=脓
nsq=弄清
nsr=侬
nst=农田
nsw=弄
nsy=农业
nsz=弄脏
nt=虐
ntb=疟
ntd=虐待
nth=虐
ntj=疟疾
ntu=虐杀
nu=怒
nub=奴婢
nuc=奴才
nuf=怒放
nuh=怒火
nui=怒斥
nul=努力
num=怒骂
nun=奴
nup=奴仆
nuq=怒气
nuu=怒视
nux=奴性
nuy=奴役
nuz=努嘴
nv=女
nvb=女伴
nvc=女厕
nve=女儿
nvf=女方
nvh=女孩
nvj=钕
nvl=女郎
nvn=女奴
nvp=女仆
nvq=女权
nvr=女人
nvs=女色
nvt=女童
nvu=女生
nvv=女装
nvw=女王
nvx=衄
nvy=女友
nvz=女子
nw=内
nwb=内部
nwc=内存
nwd=内地
nwf=内服
nwg=内功
nwh=内涵
nwj=内疚
nwk=哪
nwl=内
nwm=内幕
nwr=内容
nwu=馁
nwv=那
nww=内外
nwx=内心
nwy=内衣
nwz=内在
nx=那些
ny=那样
nz=脑子
nzl=耨
o=哦
oe=偶尔
og=嗯
omk=呣
oo=喔
ook=噢
or=偶然
ou=欧
ouc=藕
oud=沤
oue=偶尔
ouf=藕粉
oug=讴歌
ouk=呕
oul=耦
oum=欧盟
oup=藕片
ouq=怄气
our=偶
ous=藕丝
out=呕吐
ouu=偶数
ouv=欧洲
ouw=欧文
oux=怄
ouy=讴
oy=欧阳
p=平
pa=怕
pac=葩
pad=爬到
paf=扒
pag=爬过
pah=怕黑
pai=爬出
paj=帕
pak=啪
pal=耙
pam=杷
pap=怕怕
paq=爬起
par=怕人
pas=怕死
pau=怕是
pav=爬
paw=琶
pax=怕
pay=怕痒
paz=趴
pb=品
pbb=贫
pbc=拼凑
pbd=频道
pbe=聘
pbf=拼
pbh=贫寒
pbi=品尝
pbj=贫瘠
pbk=品
pbl=频率
pbm=榀
pbn=嫔
pbp=品牌
pbq=贫穷
pbr=聘任
pbs=拼死
pbt=拼图
pbv=频
pbw=品味
pby=拼音
pbz=贫嘴
pc=跑
pcb=刨
pcc=泡菜
pcd=泡
pcd=匏
pcf=抛
pcg=庖
pch=炮
pci=抛出
pcj=跑进
pck=咆
pcl=跑了
pcm=泡沫
pcn=泡妞
pco=脬
pcp=袍
pcq=狍
pcs=抛洒
pct=泡汤
pcu=抛售
pcv=炮制
pcw=抛物
pcy=泡影
pcz=跑
pd=排
pda=拍案
pdb=排版
pdc=蒎
pdd=派
pdf=拍
pdg=排骨
pdh=排行
pdi=徘
pdj=排挤
pdk=哌
pdl=排列
pdm=排名
pdn=排尿
pdp=牌
pdq=派遣
pdr=俳
pds=派送
pdt=派头
pdu=排水
pdv=拍照
pdw=排位
pdx=排序
pdz=迫
pe=普洱
pf=盆
pfb=盆
pfd=湓
pff=喷发
pfg=喷灌
pfh=喷火
pfi=喷出
pfj=盆景
pfk=喷
pfq=喷泉
pfs=喷洒
pft=喷嚏
pfu=喷射
pfx=喷血
pfy=喷涌
pg=碰
pgb=碰壁
pgc=蓬
pgd=澎
pgf=捧
pgg=捧哏
pgi=蟛
pgj=碰见
pgk=嘭
pgl=蓬莱
pgm=棚
pgo=朋
pgq=碰巧
pgr=烹饪
pgs=蓬松
pgt=堋
pgu=彭
pgv=篷
pgw=烹
pgx=怦
pgy=朋友
ph=旁
phc=蒡
phd=滂
phg=庞
phh=彷徨
phi=螃
phl=耪
pho=胖
phq=乓
phr=旁人
pht=旁听
phu=磅
phv=旁证
phw=旁
phz=逄
pi=批
pia=皮袄
pib=疲
pic=批次
pid=淠
pie=陂
pif=披
pif=擗
pig=庀
pih=癖好
pii=蜱
pij=铍
pik=啤
pil=批量
pim=枇
pin=媲
pio=脾
pip=郫
piq=脾气
pir=僻
pis=纰
pit=坯
piu=屁
piv=皮
piw=琵
pix=皮鞋
piy=霹
pj=盘
pjb=判
pjc=盘存
pjd=潘
pjf=拚
pjg=判官
pjh=盘活
pji=蟠
pjj=判决
pjk=盘亏
pjm=攀
pjn=叛逆
pjo=盼
pjp=襻
pjr=盘绕
pjs=盘算
pjt=畔
pju=盘升
pjv=磐
pjw=盼望
pjx=盘旋
pjy=攀岩
pjz=蹒
pk=凭
pka=平
pkb=瓶
pkc=萍
pkd=洴
pkf=平凡
pkg=苹果
pkh=平衡
pki=平常
pkj=瓶颈
pkk=呯
pkl=评论
pkm=枰
pkn=娉
pkp=评判
pkq=乒
pkr=俜
pks=平素
pkt=坪
pku=屏
pkv=凭证
pkw=平稳
pkx=评选
pky=评
pkz=瓶子
pl=漂亮
pm=片
pma=偏爱
pmd=片段
pmf=篇幅
pmg=偏高
pmh=翩
pmi=偏差
pmj=偏见
pmk=片刻
pml=偏离
pmm=骗
pmn=犏
pmo=胼
pmr=偏
pmu=骗术
pmv=篇
pmy=谝
pmz=蹁
pn=票
pnb=漂泊
pnd=漂
pnf=漂浮
png=飘过
pnh=飘忽
pni=螵
pnj=票据
pnk=嘌
pnl=漂亮
pnm=骠
pnn=嫖
pno=瞟
pnp=飘飘
pnq=剽窃
pnr=飘然
pns=缥
pnu=票数
pnv=飘着
pnw=票务
pnx=飘
pny=飘逸
pnz=飘在
po=破
poa=破案
pob=魄
poc=破财
pod=泼
pof=泼妇
pog=破格
poh=破坏
poi=破产
poj=钋
pok=叵
pol=攴
pom=粕
pop=鄱
poq=迫切
pos=破碎
pot=坡
pou=破
pov=颇
pow=珀
pox=婆媳
poy=迫于
poz=迫
pp=撇
ppc=苤
ppd=瞥
ppf=撇
ppj=瞥见
ppk=撇开
ppq=氕
ppx=撇下
ppz=撇嘴
pq=脾气
pr=骗人
ps=破碎
pt=平台
pu=普
pub=匍
puc=葡
pud=瀑
pue=普洱
puf=扑
pug=铺盖
puh=扑火
pui=普查
puj=铺
puk=噗
pul=铺路
pum=朴
puo=脯
pup=铺平
puq=谱曲
pur=仆
pus=菩萨
put=埔
puu=朴实
puv=普照
puw=璞
pux=谱写
puy=谱
puz=蹼
pv=配置
pw=配
pwb=配备
pwd=沛
pwe=陪
pwf=裴
pwg=配股
pwh=配合
pwi=赔偿
pwj=帔
pwk=赔
pwl=赔了
pwo=胚
pwp=陪陪
pwq=赔钱
pwr=佩
pws=辔
pwt=培
pwu=配售
pwv=配置
pww=珮
pwx=培训
pwy=霈
pwz=赔罪
px=培训
py=拼音
pz=剖
pzf=掊
pzk=剖开
pzl=剖
pzm=剖面
pzw=裒
pzx=剖析
q=去
qb=亲
qba=亲爱
qbb=寝
qbc=芹
qbd=沁
qbe=亲耳
qbf=秦
qbh=侵害
qbi=螓
qbj=钦
qbk=噙
qbk=吣
qbl=勤劳
qbm=檎
qbn=勤
qbp=钦佩
qbr=侵
qbs=琴瑟
qbt=侵吞
qbv=侵占
qbw=琴
qbx=覃
qby=亲眼
qbz=亲自
qc=其次
qd=确定
qe=全额
qf=缺乏
qg=奇怪
qh=切换
qi=其
qia=七
qib=岂不
qic=芑
qic=蕲
qid=柒
qid=漆
qie=岂
qif=旗
qig=麒
qih=启
qii=蛴
qij=颀
qik=器
qil=耆
qim=棋
qim=桤
qin=岂能
qio=脐
qip=气
qip=祈
qiq=欺
qiq=憩
qir=企
qis=绮
qit=起
qiu=砌
qiv=歧
qiw=齐
qix=期限
qiy=讫
qiz=蹊
qj=期间
qk=请
qk=情况
qka=鲭
qkb=顷
qkc=擎
qkd=清
qkf=青
qkg=庆
qkh=黥
qki=轻
qkj=清静
qkk=情况
qkm=清明
qkn=青年
qko=晴
qkp=卿
qkq=氢
qkr=倾
qks=轻松
qkt=蜻蜓
qku=磬
qku=謦
qkv=箐
qkw=请问
qkx=情
qky=请
qkz=清早
ql=强
qlb=枪毙
qlc=蔷
qld=强大
qlf=抢
qlg=强
qlh=炝
qli=蜣
qlj=镪
qlk=呛
qll=强烈
qlm=枪
qln=嫱
qlo=腔
qlp=襁
qlq=强求
qlr=戗
qlt=墙
qlu=抢手
qlv=墙纸
qlw=玱
qly=羌
qlz=跄
qm=前
qm=前面
qmb=歉
qmb=骞
qmc=茜
qmd=浅
qme=嵌
qmf=扦
qmg=牵挂
qmh=黔
qmi=堑
qmj=钱
qmj=铅
qmk=乾坤
qml=千里
qmm=前面
qmn=千年
qmo=肷
qmp=千
qmq=前期
qmr=仟
qms=缱
qmt=前天
qmu=乾
qmv=签
qmw=千万
qmx=慊
qmy=谦
qmz=迁
qn=桥
qna=翘
qnb=窍
qnc=荞
qnd=敲打
qne=峭
qnf=撬
qng=巧
qnh=巧合
qni=翘楚
qnj=锹
qnk=翘课
qnl=桥梁
qnm=橇
qno=瞧
qnp=俏皮
qnq=瞧瞧
qnr=俏
qns=缲
qnt=桥头
qnu=壳
qnv=敲诈
qnw=敲
qnx=悄
qny=乔
qnz=跷
qp=且
qpa=窃案
qpb=窃
qpc=茄
qpd=切断
qpf=挈
qpg=切割
qpi=切除
qpj=锲
qpk=切开
qpl=妾
qpm=且慢
qpn=怯懦
qpq=切
qpr=伽
qps=切碎
qpt=趄
qpu=切身
qpv=箧
qpw=切勿
qpx=怯
qpy=惬意
qpz=茄子
qq=求
qq=恰恰
qqa=鳅
qqb=酋
qqc=萩
qqd=泅
qqf=秋风
qqg=求购
qqh=秋
qqi=蚯
qqj=丘
qqk=囚
qql=丘陵
qqm=糗
qqp=丘
qqq=邱
qqr=仇
qqs=秋色
qqt=秋天
qqu=秋水
qqv=巯
qqw=球
qqx=求学
qqy=球员
qqz=逑
qr=全
qra=鬈
qrb=泉
qrc=颧
qrd=犬
qre=全额
qrf=全副
qrg=劝告
qrh=权衡
qri=蜷
qrj=拳
qrk=圈
qrl=权利
qrm=权
qrn=全年
qrp=全屏
qrq=全球
qrr=全
qrs=绻
qrt=畎
qru=权势
qrv=筌
qrw=全文
qrx=悛
qry=劝
qrz=踡
qs=穷
qsb=穹
qsc=茕
qsg=邛
qsj=穷尽
qsk=穷困
qsn=嬛
qsr=穷人
qss=穷酸
qsv=筇
qsw=琼
qt=却
qtb=瘸
qtc=鹊
qtd=确定
qtf=缺
qtg=缺钙
qth=炔
qti=雀巢
qtk=缺口
qtl=确立
qtm=阙
qtr=确认
qts=缺损
qtt=却
qtu=确
qtv=确诊
qtx=缺陷
qty=却又
qtz=确凿
qu=区
qub=癯
quc=苣
qud=渠
que=取
quf=区分
qug=去过
quh=觑
qui=蛐
quj=区间
quk=区
qul=曲
qum=驱
qun=去年
quo=瞿
qup=祛
quq=区区
qur=佢
qus=去死
qut=趣
quu=屈
quv=龋
quw=璩
qux=取消
quy=诎
quz=取走
qv=其中
qw=千万
qx=恰
qxc=葜
qxd=洽
qxf=掐
qxg=髂
qxh=恰好
qxk=卡壳
qxq=恰恰
qxr=恰如
qxs=恰似
qxt=洽谈
qxu=卡
qxx=恰
qxz=卡子
qy=群
qyf=群发
qyg=麇
qyh=群号
qyj=群居
qyk=裙裤
qyo=群殴
qyp=裙
qyt=群体
qyu=群山
qyv=群众
qyy=群友
qyz=逡
qz=亲自
r=人
ra=热爱
rb=日本
rc=绕
rcc=荛
rcd=绕道
rcf=扰
rcg=绕过
rci=绕场
rck=绕开
rcl=扰乱
rcm=桡
rcn=娆
rcr=饶人
rcs=绕
rcu=饶
rcv=绕着
rcw=绕弯
rcx=绕行
rcy=绕远
rcz=绕嘴
rd=弱点
re=热
rea=热爱
reb=热播
rec=惹
red=热带
ref=热
reg=热狗
reh=惹祸
rei=热诚
rej=热键
rel=热烈
rem=热门
ren=热闹
rep=热评
req=热情
rer=惹人
res=热死
ret=热土
reu=热身
rev=热衷
rew=热吻
rex=热心
rey=惹眼
rf=任
rfa=仁爱
rfc=荏
rfd=刃
rff=认罚
rfg=人工
rfh=稔
rfi=轫
rfj=人家
rfk=人口
rfl=人类
rfm=人民
rfn=妊
rfp=人
rfq=壬
rfr=忍
rfs=纫
rft=认同
rfu=饪
rfv=认真
rfw=韧
rfx=任性
rfy=认
rg=仍
rgd=扔到
rgf=扔
rgg=扔给
rgh=仍会
rgi=扔出
rgj=仍旧
rgl=扔了
rgn=仍能
rgr=仍
rgu=仍是
rgw=仍未
rh=让
rhb=让步
rhd=让道
rhf=攘
rhg=让给
rhh=穰
rhi=让出
rhk=嚷
rhl=让路
rhp=禳
rhq=让其
rht=壤
rhw=瓤
rhy=让
rhz=让座
ri=日
rib=日本
rig=日光
rih=日后
rii=日常
rij=日记
rik=日
ril=日历
rim=日暮
rin=日内
riq=日期
rir=日日
rit=日头
riu=日晒
riv=日照
riw=日文
rix=日线
riy=日夜
riz=日子
rj=然
rja=髯
rjb=染病
rjc=苒
rjd=染
rje=然而
rjf=染发
rjg=染缸
rjh=燃
rji=蚺
rjl=冉
rjq=燃气
rjr=冉冉
rjs=染色
rju=燃烧
rjv=染指
rjy=燃油
rjz=然则
rk=认可
rl=人类
rm=人们
rn=热闹
ro=若
rob=若不
roc=若
rod=弱点
rof=若非
rog=弱
ron=婼
ror=偌
rou=弱势
rov=箬
rox=弱小
roy=若有
roz=若在
rp=人品
rq=日期
rr=软
rre=阮
rrg=软骨
rrh=软化
rri=软
rrj=软件
rrl=软了
rro=朊
rrq=软驱
rrr=软弱
rru=软水
rrw=软卧
rry=软硬
rrz=软座
rs=容
rsa=融
rsb=冗
rsc=荣
rsd=溶
rse=嵘
rsg=戎
rsh=熔
rsi=蝾
rsj=镕
rsk=绒裤
rsl=容量
rsm=榕
rsn=容纳
rso=肜
rsq=狨
rsr=容忍
rss=绒
rsu=容身
rsv=戎装
rsw=融为
rsx=荣幸
rsy=容易
rsz=融资
rt=认同
ru=如
rub=如不
ruc=茹
rud=汝
rue=入耳
ruf=如风
rug=如果
ruh=如何
rui=辱
ruj=铷
ruk=嚅
rul=入列
rum=入门
run=如
rup=入
ruq=如期
rur=儒
rus=缛
rut=如同
ruu=入市
ruv=入住
ruw=入网
rux=如下
ruy=颥
ruz=孺
rv=认真
rvc=蕊
rvd=汭
rvh=锐化
rvi=蚋
rvj=锐
rvl=睿
rvm=枘
rvq=锐气
rvu=瑞士
rvv=睿智
rvw=瑞
rvx=瑞雪
rw=认为
rx=热线
ry=容易
ryb=润笔
ryd=润
ryf=润肤
ryh=润滑
rym=闰
ryn=闰年

rys=润色
ryu=润湿
ryy=闰月
ryz=润泽
rz=肉
rzb=肉包
rzc=揉搓
rzd=柔道
rzf=揉
rzg=鞣
rzh=柔和
rzi=柔肠
rzl=蹂躏
rzm=糅
rzp=肉铺
rzq=柔情
rzr=柔软
rzs=柔
rzt=肉体
rzu=柔顺
rzv=揉着
rzw=肉丸
rzy=肉眼
rzz=蹂
s=三
sa=撒
saa=卅
sac=萨
sad=洒
saf=撒
sah=撒谎
saj=撒娇
sak=撒开
sal=飒
san=撒尿
sao=脎
sap=撒泼
saq=撒气
sar=仨
sat=洒脱
sau=撒手
saw=撒网
sax=洒下
say=撒野
sb=随便
sc=扫
sca=鳋
scb=瘙
scd=骚动
scf=搔
scg=扫过
sch=扫黄
sci=扫除
sck=骚客
scl=骚乱
scm=骚
scn=嫂
sco=臊
scp=扫平
scr=骚扰
scs=缫
sct=埽
scu=扫射
scv=扫帚
scw=扫尾
scx=扫兴
scz=嫂子
sd=赛
sda=鳃
sdb=塞
sdd=赛道
sdh=赛后
sdi=赛场
sdj=赛季
sdk=噻
sdm=赛马
sdo=腮
sdp=赛跑
sdq=赛前
sdv=赛制
sdw=塞外
sdz=塞子
se=色
seb=塞
sec=色彩
sed=涩
seg=色鬼
seh=穑
sei=色差
sej=铯
sel=色狼
sem=色盲
seq=色情
ser=色弱
ses=色素
seu=啬
sew=瑟
sex=色相
sey=色诱
sez=色泽
sf=森
sfl=森林
sfm=森
sfs=森森
sfy=森严
sg=僧
sgd=僧道
sgn=僧尼
sgp=僧袍
sgs=僧俗
sh=似乎
shc=桑蚕
shd=丧胆
shf=搡
shk=嗓
shl=丧礼
shm=嗓门
sho=丧偶
shq=丧气
shu=丧
shv=丧钟
shy=桑
shz=嗓子
si=四
sia=肆
sib=私奔
sic=四次
sid=死
sif=撕
sig=四个
sih=私
sii=厮
sij=锶
sik=嘶
sil=耜
sim=驷
sin=姒
sip=祀
siq=斯
sir=似
sis=缌
sit=思
siu=饲
siv=司
siw=死亡
six=思想
siy=糸
siz=私自
sj=散
sja=三
sjb=散步
sjc=散
sjd=三代
sjf=散发
sjg=三个
sjh=散伙
sjj=三级
sjk=散开
sjl=散了
sjm=糁
sjr=伞
sjs=叁
sju=馓
sjv=三种
sjw=三围
sjy=霰
sk=思考
sl=算了
sm=什么
sn=随你
so=所
soa=索爱
sob=缩编
soc=蓑
sod=挲
sof=缩放
soh=所获
soi=所处
soj=锁
sok=唆
sol=所列
som=梭
son=索尼
soo=睃
sop=索赔
soq=索取
sor=索然
sos=缩
sot=所提
sou=索
sov=所致
sow=琐
sox=所需
soy=羧
soz=所在
sp=索赔
sq=索取
sr=算
src=蒜
srd=酸度
srf=算法
srg=算卦
srh=算好
sri=算出
srj=算计
srk=酸苦
srl=算了
srm=算命
srn=酸奶
srp=算盘
srq=狻
srr=酸软
srs=算算
srt=酸痛
sru=算术
srv=算
srw=酸味
sry=酸
srz=算作
ss=送
ssb=宋
ssc=菘
ssd=淞
sse=嵩
ssf=送饭
ssg=送给
ssh=送回
ssi=送出
ssj=松紧
ssk=松开
ssl=竦
ssm=松
ssq=送去
ssr=耸
sss=送死
sst=宋体
ssu=送上
ssx=忪
ssy=讼
ssz=送
st=洒脱
su=苏
sua=稣
sub=塑
suc=蔌
sud=觫
sud=涑
suf=素
sug=甦
sui=俗称
suj=夙
suk=嗉
sul=塑料
sum=素描
sun=俗念
suq=俗气
sur=俗
sus=诉讼
sut=俗套
suu=诉说
suv=肃
suw=俗物
sux=粟
suy=诉
suy=酥
suz=速
sv=岁
svb=随便
svc=荽
svd=濉
sve=随
svf=随风
svg=髓
svh=穗
svh=燧
svi=祟
svj=随即
svk=虽
svl=碎了
svm=岁末
svn=虽能
svo=眭
svp=碎片
svr=虽然
svs=绥
svt=随同
svu=碎
svu=尿
svv=随着
svw=虽无
svy=岁月
svz=遂
sw=所谓
sx=思想
sy=所以
syc=荪
sye=孙儿
syf=损
sym=榫
syn=孙女
syq=狲
syr=隼
syu=损失
syv=笋
syx=飧
syy=损益
syz=孙
sz=搜
szb=搜捕
szc=薮
szd=溲
szf=擞
szg=搜狗
szh=搜狐
szi=螋
szj=飕
szk=嗖
szl=搜罗
szo=瞍
szp=叟
szs=搜索
szu=馊
szv=艘
szw=馊味
szx=搜寻
t=他
ta=她
taa=鳎
tab=它
tad=溻
taf=拓
tai=踏春
taj=铊
tak=嗒
tam=榻
tan=她
tap=踏平
taq=獭
tar=他
tat=塌
tau=沓
tav=踏着
taz=踏
taz=遢
tb=特别
tc=套
tcb=逃避
tcc=萄
tcd=涛
tce=陶
tcf=掏
tcg=弢
tch=桃花
tci=掏出
tcj=讨教
tck=啕
tcl=讨论
tcm=桃
tcn=逃难
tcp=逃跑
tcq=淘气
tcr=讨饶
tcs=绦
tct=淘汰
tcu=逃生
tcv=讨债
tcw=韬
tcx=套现
tcy=讨
tcz=逃
td=太
td=推动
tda=鲐
tdb=太笨
tdc=苔
tdd=汰
tde=胎儿
tdf=抬
tdg=太高
tdh=太好
tdi=太长
tdj=钛
tdk=呔
tdm=骀
tdn=太难
tdo=胎
tdp=太平
tdq=抬起
tdr=太热
tds=台
tdt=态
tdw=太晚
tdx=太小
tdy=酞
tdz=跆
te=特
teb=特别
tec=特此
ted=特点
teh=特好
tei=特长
tej=铽
tek=慝
tel=特例
tem=特卖
ten=特
tep=特批
tes=特色
teu=特殊
tev=特征
tew=特务
tex=忑
tey=忒
tf=头发
tg=腾
tga=疼爱
tgb=疼
tgc=藤
tgf=腾飞
tgi=腾出
tgj=誊
tgk=腾空
tgn=腾挪
tgo=滕
tgt=疼痛
tgx=腾讯
th=汤
thc=搪瓷
thd=烫
thf=搪
thg=唐
thh=堂皇
thi=螳
thj=镗
thk=嘡
thl=耥
thm=糖
thn=帑
tho=膛
thr=倘
ths=唐宋
tht=趟
thu=躺
thv=躺着
thw=瑭
thx=堂
thy=羰
thz=蹚
ti=体
tia=提案
tib=剃
tic=荑
tid=涕
tif=提
tig=提高
tih=体会
tij=锑
tik=啼
tik=嚏
til=体力
tim=梯
tin=体能
tio=题
tip=裼
tiq=提前
tir=倜
tis=缇
tit=堤
tiu=屉
tiv=体制
tiw=体温
tix=悌
tiy=醍
tiz=踢
tj=谈
tj=推荐
tjb=瘫
tjc=贪财
tjd=滩
tje=炭
tjf=摊
tjg=弹
tjh=郯
tji=弹出
tjj=钽
tjk=叹
tjl=谈论
tjm=毯
tjo=昙
tjp=袒
tjr=贪
tjs=探索
tjt=坦
tju=碳
tjw=贪污
tjx=覃
tjy=谭
tjz=弹奏
tk=听
tkc=葶
tkd=汀
tke=聤
tkf=挺
tkg=庭
tkh=烃
tki=厅
tkj=铤
tkk=听
tkl=听了
tkm=梃
tkn=婷
tkp=听凭
tkq=听取
tkr=停
tkt=町
tku=听说
tkv=艇
tkw=亭
tkx=停下
tky=霆
tkz=廷
tl=讨论
tm=天
tma=天
tmc=天才
tmd=添
tme=天鹅
tmf=掭
tmg=天国
tmh=天黑
tmi=填充
tmj=铦
tmk=田
tml=天亮
tmm=阗
tmn=天年
tmo=腆
tmp=天平
tmq=甜
tmr=佃
tms=天色
tmt=填
tmu=天上
tmv=天真
tmw=兲
tmx=恬
tmy=天涯
tmz=天子
tn=调
tna=鲦
tnb=窕
tnc=苕
tnd=挑逗
tnf=挑
tng=跳高
tnh=调和
tni=蜩
tnj=条件
tnk=跳空
tnl=条例
tno=眺
tnp=祧
tnq=挑起
tnr=佻
tnt=挑剔
tnu=跳水
tnv=龆
tnw=条
tnx=挑选
tny=条约
tnz=跳
to=托
toa=橐
tob=拖把
toc=托词
tod=沱
toe=陀
tof=拖
tof=拓
tog=庹
toh=拓荒
toi=脱产
toj=铊
tok=唾
tol=脱离
tom=驼
tom=椭
ton=鸵
too=脱
top=妥
toq=拖欠
tor=佗
tos=脱俗
tot=坨
tou=砣
tov=箨
tow=妥为
tox=拖鞋
toy=酡
toz=跎
tp=贴
tpb=铁板
tpc=萜
tpd=餮
tpg=铁杆
tpi=贴出
tpj=铁
tpk=贴
tpl=铁路
tpm=贴面
tpr=铁人
tps=铁丝
tpt=贴图
tpu=贴身
tpv=贴着
tpw=铁腕
tpx=怗
tpz=帖子
tq=提前
tr=团
trd=湍
trf=抟
trg=团购
trh=团伙
trj=团结
trk=团
trl=湍流
trt=疃
trv=彖
trw=团委
try=团圆
ts=同
tsb=痛
tsc=茼
tsd=彤
tse=峒
tsf=捅
tsh=童话
tsi=通常
tsj=铜
tsk=嗵
tsl=童
tsm=桶
tsm=桐
tsn=童年
tso=瞳
tsp=通篇
tsq=同情
tsr=侗
tss=统
tst=垌
tsu=砼
tsv=筒
tsw=通往
tsx=恸
tsy=酮
tsz=通
tt=天天
tu=图
tua=图案
tub=突
tuc=荼
tud=涂
tue=徒儿
tuf=突发
tuh=秃
tui=徒
tuj=钍
tuk=吐
tul=凸
tum=涂抹
tup=图片
tuq=突起
tur=突然
tus=徒孙
tut=堍
tuu=土
tuv=途中
tuw=图文
tuy=酴
tuz=途
tv=推
tvb=退步
tvc=推测
tvd=推导
tvf=推
tvg=推广
tvh=颓
tvh=煺
tvi=蜕
tvk=推开
tvn=推拿
tvo=腿
tvp=褪
tvq=推敲
tvr=退让
tvs=推算
tvt=推脱
tvu=腿上
tvw=退伍
tvx=退休
tvy=忒
tvz=退
tw=台湾
tx=同学
ty=统一
tya=屯
tyd=吞掉
tyf=吞服
tyj=囤积
tyk=囤
tyl=吞了
tym=吞没
tyo=豚
typ=褪
tyr=氽
tyt=吞
tyu=臀
tyw=臀围
tz=头
tz=投资
tza=投案
tzb=投标
tzc=头寸
tzd=头
tzf=投
tzg=骰
tzh=头昏
tzi=透彻
tzj=投机
tzk=偷窥
tzl=透露
tzm=透明
tzn=头脑
tzp=投票
tzq=透气
tzr=偷
tzs=投诉
tzt=头痛
tzu=头上
tzv=透支
tzw=头尾
tzx=投降
tzz=透
u=是
ua=啥
uab=痧
uac=莎
uad=沙
uad=挲
uaf=沙发
uag=傻瓜
uah=杀害
uai=厦
uaj=铩
uak=嗄
ual=傻了
uam=杉
uaq=歃
uar=傻
uas=纱
uat=沙滩
uau=砂
uav=杀猪
uax=杀
uay=霎
uaz=傻子
ub=顺便
uc=少
ucb=勺
ucc=苕
ucd=邵
uce=少儿
ucf=捎
uch=稍
uci=蛸
uck=哨
ucl=韶
ucm=梢
ucn=少年
ucq=烧钱
ucs=绍
ucu=少数
ucv=艄
ucv=筲
ucw=稍微
ucx=少
ucy=少爷
ucz=稍作
ud=晒
udd=色
udg=晒干
udh=晒黑
udk=筛糠
udo=晒
udu=晒晒
udv=筛
udx=筛选
udy=酾
ue=设
uea=涉案
ueb=设备
ued=涉
uef=摄
ueg=麝
ueh=社会
uei=蛇
uei=厍
uej=涉及
uek=赊
uel=设立
uem=射门
uep=社
ueq=舌
uer=舍
ues=射死
uet=赦
ueu=射
uev=设置
uew=奢望
uex=慑
uey=设
uez=涉足
uf=深
ufa=深奥
ufb=审
ufc=莘
ufd=沈
ufe=甚而
uff=身份
ufg=身高
ufh=燊
ufi=蜃
ufk=呻
ufk=哂
ufl=申
ufm=糁
ufn=婶
ufo=胂
ufp=身
ufq=甚
ufr=什
ufr=伸
ufs=参
ufs=绅
uft=身体
ufu=砷
ufw=珅
ufx=慎
ufy=诜
ufz=身姿
ug=生
ugb=生病
ugc=生存
ugd=渑
uge=嵊
ugg=升高
ugh=剩
ugi=盛
ugj=生姜
ugk=声卡
ugl=胜利
ugm=声明
ugn=牲
ugo=胜
ugp=升
ugq=剩
ugr=生日
ugs=绳
ugu=声
ugv=笙
ugw=生物
ugx=剩下
ugy=圣
ugz=生在
uh=上
uha=上岸
uhc=上次
uhd=殇
uhf=上方
uhg=伤感
uhh=熵
uhi=上场
uhj=上级
uhk=上课
uhl=商量
uhm=上面
uhn=上年
uho=晌
uhp=上屏
uhq=上去
uhr=伤
uhs=绱
uht=墒
uhv=上涨
uhw=商
uhx=尚
uhx=裳
uhy=上演
uhz=尚在
ui=时
uia=事
uib=实
uic=蓍
uid=湿
uie=示
uif=拾
uig=时光
uih=炻
uii=轼
uij=时间
uik=嗜
uil=师
uim=驶
uin=始
uio=匙
uip=视
uiq=狮
uiq=舐
uir=使
uis=失色
uit=螫
uiu=蚀
uiv=尸
uiv=虱
uiw=市
uix=恃
uiy=式
uiz=适
uj=山
uja=鳝
ujb=单
ujc=删
ujc=芟
ujd=汕
ujd=潸
uje=陕
ujf=擅
ujg=删改
ujh=扇
uji=蟮
ujj=钐
ujk=赡
ujl=闪亮
ujm=闪
ujn=姗
ujo=膳
ujp=衫
ujq=煽情
ujr=闪人
ujt=山头
ujv=舢
ujw=珊
ujx=陕西
ujy=善
ujz=跚
uk=帅
ukc=帅才
ukd=摔倒
ukf=摔
ukg=帅哥
ukh=摔坏
uki=蟀
ukj=衰竭
ukk=甩
ukl=帅
ukm=甩卖
ukp=甩
ukq=帅气
ukr=衰弱
uks=摔死
ukt=衰退
uku=摔伤
ukv=率真
ukw=衰
ukx=率先
ul=双
ula=爽
梁歪
ulc=双层
uld=爽
ule=双耳
ulf=双方
uli=双重
ulj=双击
ulk=爽快
ull=爽朗
ulm=双面
uln=孀
ulp=双排
ulq=双亲
ulr=双人
uly=霜
um=上面
un=熟能生巧
uo=说
uob=朔
uoc=蒴
uod=说道
uof=搠
uog=说过
uoh=烁
uoi=说出
uoj=铄
uol=说了
uom=说明
uon=妁
uop=说破
uoq=说情
uou=硕
uov=说着
uow=说完
uox=说笑
uoy=说
up=双拼
uq=事情
ur=拴
urd=涮
urm=闩
urv=拴住
us=神似
ut=身体
uu=数
uua=束
uuc=薯
uud=殊
uue=数额
uuf=抒
uug=庶
uuh=黍
uuh=秫
uui=输
uuj=鼠
uuj=殳
uuk=赎
uul=竖
uum=树
uun=恕
uun=姝
uuo=暑
uup=薯片
uur=舒
uur=倏
uus=署
uut=舒坦
uuu=属
uuv=书
uuw=熟
uux=熟悉
uuz=述
uv=水
uvb=水表
uvc=水草
uve=税额
uvf=水分
uvg=水果
uvh=税
uvi=水产
uvj=睡觉
uvk=水库
uvl=水利
uvm=睡眠
uvn=水泥
uvo=睡
uvp=水平
uvt=水土
uvv=睡着
uvw=税务
uvy=谁
uvz=水藻
uw=谁
uwu=谁说
uwv=谁知
ux=首先
uxe=耍
uxk=唰
uxl=耍赖
uxn=耍弄
uxp=刷屏
uxu=刷
uxx=刷新
uxz=刷子
uy=顺
uyb=顺便
uyc=顺从
uyd=顺道
uye=顺耳
uyf=顺风
uyi=顺
uyk=吮
uyl=顺利
uyo=瞬
uyp=舜
uyv=顺着
uyx=顺序
uyy=顺延
uyz=顺嘴
uz=受
uzb=首
uzc=收藏
uzd=受到
uze=首尔
uzf=授
uzg=收工
uzh=守候
uzi=首创
uzj=手机
uzk=收看
uzl=手里
uzm=寿命
uzn=首脑
uzp=手
uzq=狩
uzr=售
uzs=绶
uzt=手头
uzu=收市
uzv=收
uzw=熟
uzx=首先
uzy=首页
uzz=守则
v=这
va=扎
vab=痄
vac=榨菜
vad=渣
vaf=揸
vag=扎根
vah=炸
vai=轧
vaj=铡
vak=喳
val=栅栏
vam=榨
vao=眨
vap=乍
vaq=猹
vas=炸死
vat=渣土
vau=砟
vay=诈
vaz=齄
vb=准备
vc=找
vca=招安
vcb=照办
vcd=召
vce=兆
vcf=招
vcg=照顾
vch=肇
vci=找出
vcj=钊
vck=嘲
vcl=找来
vcm=棹
vco=照
vcp=爪
vcq=朝气
vcr=找人
vcs=罩
vct=赵
vcu=朝
vcv=笊
vcx=找寻
vcy=诏
vcz=沼泽
vd=知道
vdb=窄
vdf=摘
vdi=摘除
vdj=斋戒
vdk=债款
vdp=祭
vdq=债券
vdr=债
vdv=砦
vdw=斋
vdx=翟
vdy=摘要
vdz=摘自
ve=着
veb=这边
vec=蔗
ved=浙
vee=陬
vef=折
veg=鹧
veh=折合
vei=辙
vej=锗
vek=嗻
vel=者
vem=柘
vep=褶
ver=折让
ves=折算
vet=赭
veu=喆
vev=这种
vew=这位
vex=哲学
vey=谪
vez=遮
vf=真
vfa=臻
vfb=疹
vfc=蓁
vfd=浈
vfd=溱
vfe=阵
vff=振
vfg=珍贵
vfh=稹
vfi=轸
vfj=镇
vfk=赈
vfl=贞
vfm=枕
vfn=震怒
vfo=朕
vfp=祯
vfq=斟
vfr=侦
vfs=缜
vft=圳
vfu=砧
vfv=箴
vfw=珍
vfx=甄
vfy=震
vfz=振作
vg=正
vga=正
vgb=郑
vgc=蒸
vgd=争
vge=峥
vgf=挣
vgf=拯
vgg=整个
vgh=正好
vgi=征
vgj=铮
vgk=睁开
vgl=烝
vgm=证明
vgn=狰狞
vgo=睁
vgp=正派
vgq=狰
vgr=正如
vgs=正色
vgt=整体
vgu=整
vgv=政
vgv=筝
vgw=正文
vgx=怔
vgy=证
vgz=正在
vh=长
vha=丈
vhb=瘴
vhc=账册
vhd=涨
vhe=障
vhg=张
vhh=账号
vhi=蟑
vhj=帐
vhk=账
vhl=章
vhl=鄣
vhm=樟
vhn=嫜
vho=胀
vhq=獐
vhr=仗
vhs=长孙
vht=涨停
vhv=仗着
vhw=璋
vhx=掌
vhy=张扬
vhz=张嘴
vi=只
vi=支持
via=至
vib=旨
vic=芝
vid=治
vid=汁
vie=职
vif=指
vif=挚
vig=只管
vih=秩
vii=咫
vij=帜
vik=吱
vil=止
vim=枝
vim=枳
vin=只能
vio=脂
vip=制
vip=祗
viq=之前
vir=值
vis=纸
vit=址
viu=知
viu=智
viv=彘
viw=职务
vix=忮
viy=识
viz=踯
viz=跖
vj=占
vjc=蘸
vjd=沾
vje=崭
vjf=搌
vji=斩
vjj=盏
vjk=展开
vjl=站
vjm=粘
vjo=瞻
vjp=站牌
vjq=站起
vjs=绽
vju=展
vjv=站住
vjw=颤
vjx=怗
vjy=谵
vjz=站在
vk=拽
vkf=拽
vkq=拽起
vkv=拽住
vkz=跩
vl=装
vlb=装备
vld=状
vlf=撞
vlg=庄
vlh=装潢
vli=撞车
vlj=幢
vlk=状况
vll=戆
vlm=桩
vlp=奘
vlq=撞墙
vlr=僮
vls=撞死
vlt=状态
vlu=装饰
vlv=奘
vlx=装修
vlz=装在
vm=这么
vn=只能

vo=桌
vob=桌布
voc=茁
vod=浊
vof=捉
voh=灼
voi=捉虫
voj=镯
vok=啄
vol=卓
vom=棹
von=捉弄
vop=禚
voq=桌球
vor=倬
vos=缴
vot=灼痛
vou=斫
vov=着重
vow=琢
vox=着想
voy=酌
voz=桌子
vp=只怕
vq=正确
vr=转
vra=专
vrb=转变
vrc=转存
vrd=转到
vre=颛
vrf=撰
vrg=转告
vrh=转换
vri=转
vrj=专家
vrk=赚
vrl=赚了
vrm=专门
vrp=转盘
vrq=赚钱
vrr=传
vrs=转送
vrt=专题
vru=砖
vrv=篆
vrw=转为
vrx=专项
vry=专研
vrz=转载
vs=中
vsa=钟爱
vsb=冢
vsc=仲裁
vsd=终点
vsf=中方
vsg=中国
vsh=种
vsi=忠诚
vsj=钟
vsk=中肯
vsl=中
vsn=中年
vso=肿
vsp=重
vsq=中期
vsr=众
vss=终
vst=中途
vsu=忠实
vsv=忠
vsv=舯
vsw=衷
vsx=中心
vsz=踵
vt=折腾
vu=主
vub=瘃
vuc=著
vud=注
vud=渚
vuf=拄
vug=竹
vuh=烛
vui=蛛
vuj=铸
vuk=嘱
vul=煮
vum=驻
vum=株
vun=朱
vuo=瞩
vup=祝
vuq=猪
vur=住
vus=住宿
vut=主体
vuu=注释
vuv=筑
vuw=珠
vuy=诸
vuz=逐
vv=追
vv=真正
vvb=追捕
vve=坠
vvf=赘
vvg=追高
vvh=坠毁
vvi=追查
vvj=锥
vvl=坠落
vvm=椎
vvn=追念
vvp=追捧
vvq=追求
vvr=隹
vvs=缀
vvv=追逐
vvw=追问
vvx=惴
vvy=追忆
vvz=追
vw=掌握
vwh=这回
vwz=这
vx=抓
vxb=抓捕
vxf=抓
vxh=抓获
vxk=抓狂
vxp=爪
vxv=抓住
vxx=抓瞎
vxy=抓药
vy=这样
vya=屯
vyb=窀
vyd=准

vyn=准能
vyo=肫
vyq=准确
vyr=准入
vyt=准头
vyy=谆
vyz=准则
vz=周
vzb=宙
vzc=荮
vzd=州
vze=帚
vzg=粥
vzi=轴
vzj=洲际
vzk=咒
vzl=周六
vzm=骤
vzn=妯
vzo=肘
vzp=舟
vzq=周期
vzr=周日
vzs=绉
vzt=周天
vzu=碡
vzv=籀
vzw=周围
vzx=周旋
vzy=诌
vzz=周遭
w=我
wa=挖
waa=瓦
wab=挖补
wad=洼
waf=挖
wag=瓦罐
wai=蛙
waj=挖掘
wak=哇
wal=瓦砾
wam=挖煤
wan=娃
wao=腽
wap=袜
war=佤
was=哇塞
waw=娃娃
way=蛙泳
waz=袜子
wb=五笔
wc=为此
wd=外
wdb=歪
wdc=外侧
wde=崴
wdf=歪风
wdg=外观
wdh=外汇
wdi=外出
wdk=外壳
wdl=外来
wdm=外面
wdp=歪
wdq=歪曲
wdr=外人
wds=外孙
wdt=外套
wdu=外甥
wdx=外星
wdy=外语
wdz=外在
we=玩儿
wf=问
wfb=瘟
wfc=文采
wfd=温
wff=揾
wfg=问过
wfh=稳
wfi=蚊
wfj=文件
wfk=吻
wfl=紊乱
wfm=闻
wfn=温暖
wfp=攵
wfq=温泉
wfr=温柔
wfs=纹
wft=问题
wfu=文书
wfw=文
wfx=文学
wfy=雯
wfz=蚊子
wg=翁
wgb=瓮
wgc=蓊
wgk=嗡
wgt=奣
wgw=嗡嗡
wgx=翁婿
wh=王
wha=王
whb=网吧
whd=汪
whg=魍
whh=王后
whi=往
whj=忘记
whk=网
whl=忘了
whm=枉
whn=往年
who=旺
whp=网盘
whr=往日
whs=网速
whu=网上
whv=网站
whw=望
whx=惘
why=网友
whz=王子
wi=完成
wj=完
wja=万
wjb=皖
wjc=莞
wjd=湾
wje=顽
wjf=挽
wjg=顽固
wjh=烷
wji=蜿
wjk=顽抗
wjl=晚了
wjn=婉
wjo=晚
wjp=丸
wjq=完全
wjs=纨
wjt=畹
wju=碗
wjv=完整
wjw=玩
wjx=惋
wjy=万元
wk=唯恐
wl=为了
wm=我们
wn=无奈
wo=握
wob=窝
woc=莴
wod=沃
wof=挝
wog=我国
woi=卧
woj=幄
wok=喔
wom=我们
won=窝囊
woo=肟
wop=我
woq=握拳
wor=倭
wou=斡
wov=龌
wp=网盘
wq=完全
wr=微软
ws=猥琐
wt=问题
wu=无
wua=五
wub=勿
wub=寤
wuc=芜
wud=污
wue=阢
wuf=捂
wug=巫
wuh=焐
wui=蜈
wuj=钨
wuj=鼯
wuk=吴
wul=无论
wum=梧
wum=杌
wun=物
wuo=晤
wup=舞
wuq=无穷
wur=伍
wus=婺
wut=圬
wuu=屋
wuv=毋
wuw=务
wux=悟
wuy=误
wuy=诬
wuz=迕
wv=为止
ww=为
wwa=未
wwb=痿
wwc=薇
wwc=葳
wwd=危
wwe=巍
wwf=违法
wwg=违规
wwh=委
wwi=微
wwj=帷
wwk=味
wwl=为了
wwm=闱
wwn=娓
wwo=韪
wwp=尾盘
wwq=猥
wwr=伟
wws=维
wwt=胃
wwt=畏
wwu=尾
wwv=卫
www=威
wwx=威
wwy=谓
wwz=违
wx=无线
wy=唯一
wz=文字
x=小
xa=西安
xb=新
xba=心爱
xbb=新版
xbc=芯
xbd=心
xbh=信号
xbj=锌
xbk=辛苦
xbl=辛
xbm=心目
xbo=昕
xbp=囟
xbq=辛勤
xbr=信
xbs=心思
xbt=心态
xbu=馨
xbw=新闻
xbx=衅
xbx=忻
xc=下次
xd=相当
xe=险恶
xf=想法
xg=习惯
xh=喜欢
xi=系
xia=西
xib=兮
xic=昔
xic=菥
xid=洗
xie=隙
xif=西方
xig=席
xih=稀
xih=熄
xii=熙
xij=锡
xij=舄
xik=吸
xil=袭
xim=析
xim=粞
xin=嬉
xin=牺
xio=膝
xip=夕
xip=奚
xiq=吸取
xir=翕
xir=歙
xis=细
xit=系统
xiu=喜
xiu=硒
xiv=习
xiw=席位
xix=希
xiy=戏
xiz=息
xj=现金
xk=行
xka=行啊
xkb=性别
xkc=荇
xkd=行动
xke=陉
xkf=擤
xkg=性格
xkh=幸好
xki=行
xkj=性急
xkk=形
xkl=醒了
xkm=杏
xkn=姓
xko=星
xkp=行骗
xkq=猩
xkr=形容
xks=形似
xkt=幸
xku=省
xkv=兴致
xkw=行为
xkx=性
xky=醒
xkz=星座
xl=想
xla=相爱
xlb=相比
xlc=巷
xld=象
xle=降
xlf=享福
xlg=项
xlh=香
xli=厢
xlj=镶
xlk=响
xll=相连
xlm=相
xln=想念
xlp=向
xlq=象棋
xlr=像
xls=缃
xlt=相同
xlu=饷
xlv=乡
xlw=享
xlx=飨
xly=详
xlz=箱子
xm=先
xm=下面
xma=鲜
xmb=宪
xmc=藓
xmc=苋
xmd=冼
xme=限
xme=岘
xmf=掀
xmg=弦
xmi=衔
xmi=蚬
xmj=铣
xmk=现款
xml=贤
xmm=闲
xmn=嫌
xmn=娴
xmo=显
xmp=祆
xmq=县
xmr=仙
xms=线
xmt=线条
xmu=献
xmv=舷
xmv=筅
xmw=现
xmx=咸
xmy=羡
xmz=跹
xn=笑
xnb=宵
xnc=萧
xnd=消
xne=崤
xnf=消费
xng=魈
xnh=消化
xni=消除
xnj=销
xnk=啸
xnl=孝
xnm=校
xnm=骁
xnn=小鸟
xno=晓
xnp=枭
xnq=小气
xnr=笑容
xns=绡
xnt=萧条
xnu=硝
xnv=箫
xnw=效
xnx=肖
xny=霄
xnz=逍
xo=西欧
xp=些
xpb=写
xpc=薤
xpd=泄
xpd=蟹
xpe=邪恶
xpf=携
xpg=鞋
xph=燮
xpi=蝎
xpj=谢绝
xpk=叶
xpl=勰
xpm=械
xpm=榭
xpn=邪念
xpo=歇
xpp=血
xpq=獬
xpr=斜
xps=绁
xpt=协调
xpu=协
xpv=些
xpw=卸
xpx=懈
xpy=谢
xpy=谐
xpz=邂
xq=修
xqa=髹
xqb=宿
xqc=莠
xqd=溴
xqe=岫
xqf=修复
xqg=庥
xqh=秀
xqj=锈
xqk=嗅
xqm=朽
xqn=修女
xqp=袖
xqq=秀气
xqr=休
xqs=绣
xqu=馐
xqv=貅
xqw=琇
xqx=休息
xqy=羞
xqz=臭
xr=选
xra=悬案
xrb=宣
xrc=萱
xrd=渲
xrf=旋
xrf=揎
xrg=选购
xrh=炫
xri=轩
xrj=铉
xrk=喧
xrl=旋律
xrm=楦
xrn=嬛
xro=眩
xrp=禤
xrq=悬
xrr=儇
xrs=绚
xrt=选题
xru=碹
xrv=旋转
xrw=玄
xry=谖
xrz=选择
xs=熊
xsa=凶案
xsb=匈
xsc=芎
xsd=汹
xse=凶恶
xsg=凶光
xsh=雄厚
xsj=胸襟
xsk=兄
xsl=雄鹿
xsm=熊猫
xsn=匈奴
xso=胸
xsq=胸前
xss=熊
xst=胸膛
xsu=雄
xsv=兄长
xsw=雄伟
xsx=凶
xsy=汹涌
xsz=雄姿
xt=学
xta=鳕
xtb=穴
xtc=薛
xtd=学到
xtf=踅
xtg=靴
xth=学会
xti=学成
xtj=削减
xtk=噱
xtl=学历
xtm=学名
xtn=学年
xtp=血
xtr=血肉
xts=血色
xtt=噱头
xtu=学生
xtv=彐
xtw=学位
xtx=削
xtx=泶
xty=雪
xty=谑
xtz=靴子
xu=需
xub=续保
xuc=蓄
xud=溆
xuf=续费
xug=序
xuh=虚
xui=徐
xuj=旭
xuk=嘘
xul=序列
xum=栩
xun=婿
xuo=煦
xup=须
xur=叙
xus=续
xut=墟
xuu=虚实
xuv=胥
xuw=畜
xux=恤
xuy=许
xuz=虚增
xv=限制
xw=希望
xx=下
xx=学习
xxa=夏
xxb=下班
xxc=瑕疵
xxd=下跌
xxe=峡
xxf=罅
xxh=黠
xxi=虾
xxj=下级
xxk=吓
xxo=瞎
xxp=下排
xxq=狭
xxr=侠
xxs=吓死
xxt=夏天
xxu=硖
xxv=下周
xxw=瑕
xxy=霞
xxz=遐
xy=需要
xya=鲟
xyb=旬
xyc=薰
xyd=殉
xye=寻
xyh=寻欢
xyi=循
xyk=勋
xym=驯
xyn=殉难
xyo=曛
xyp=熏
xyq=獯
xyr=寻人
xys=绚
xyt=埙
xyv=寻找
xyw=珣
xyx=恂
xyy=讯
xyy=醺
xyz=迅
xz=现在
xz=选择
y=一
ya=亚
yaa=牙
yab=丫
yac=芽
yad=涯
yae=崖
yaf=押
yag=牙膏
yah=雅虎
yai=压
yai=衙
yaj=鸭
yak=呀
yak=吖
yal=压力
yam=桠
yan=娅
yao=睚
yap=压迫
yaq=氩
yar=伢
yas=压缩
yat=垭
yau=砑
yav=亚洲
yaw=琊
yax=雅兴
yay=雅
yay=讶
yaz=迓
yb=因
yba=阴暗
ybb=瘾
ybb=寅
ybc=荫
ybd=淫
ybe=阴
ybg=引
ybh=银行
ybi=蚓
ybj=银
ybk=吟
ybl=音
ybm=隐瞒
ybn=姻
ybp=印
ybq=狺
ybt=垠
ybu=饮
ybv=尹
ybv=龈
ybw=因为
ybx=夤
yby=霪
yc=要
yca=尧
ycb=窑
ycc=药
ycd=淆
yce=陶
ycf=摇
ycg=妖怪
ych=要好
yci=徭
ycj=钥
yck=咬
ycm=杳
ycn=妖
yco=腰
ycp=夭
ycq=邀请
ycr=侥
ycs=约
yct=摇头
ycu=要是
ycv=幺
ycw=瑶
ycx=耀
ycy=谣
ycz=邀
yd=一定
ye=也
yea=页
yeb=爷
yec=野草
yed=液
yee=耶
yef=揶
yeg=也该
yeh=烨
yei=靥
yej=铘
yek=叶
yel=业
yem=椰
yen=也难
yeo=腋
yep=叶片
yer=野人
yes=也算
yet=液态
yeu=也是
yev=也
yew=夜
yex=也许
yey=邺
yey=邪
yez=叶子
yf=缘分
yg=应该
yh=样
yhb=痒
yhc=洋葱
yhd=洋
yhd=漾
yhe=阳
yhf=扬
yhg=鞅
yhh=秧
yhi=徉
yhi=蛘
yhj=飏
yhl=央
yhm=杨
yhn=羊奶
yho=旸
yhp=样品
yhq=氧
yhr=仰
yht=阳台
yhw=玚
yhx=怏
yhy=养
yhz=样子
yi=以
yia=弋
yib=益
yib=肄
yic=艺
yid=溢
yid=漪
yie=屹
yif=抑
yig=一个
yih=移
yii=役
yii=颐
yij=镒
yij=镱
yik=医
yik=呓
yil=毅
yil=翊
yim=椅
yin=姨
yio=易
yip=祎
yiq=猗
yir=依
yir=伊
yis=异
yit=圯
yiu=壹
yiv=已
yiv=彝
yiw=亦
yiw=奕
yix=翼
yix=怡
yiy=议
yiz=遗
yiz=劓
yj=眼
yja=延安
yjb=宴
yjc=菸
yjd=演
yjd=淹
yje=岩
yjf=艳
yjg=阉割
yjh=烟
yjh=焱
yji=颜
yji=衍
yjj=鼹
yjk=咽
yjk=郾
yjl=严厉
yjm=验
yjm=檐
yjn=燕
yjo=腌
yjp=殷
yjq=眼前
yjr=偃
yjs=罨
yjt=盐
yjt=埏
yju=研
yjv=筵
yjv=鄢
yjw=言
yjw=琰
yjx=恹
yjy=严
yjz=延
yk=应
ykb=颖
ykc=英
ykc=莹
ykd=瀛
yke=婴儿
ykf=撄
ykg=鹰
ykg=膺
ykh=迎合
yki=蝇
ykj=迎接
ykk=婴
ykk=鹦
ykl=盈利
ykm=樱
ykm=楹
ykn=盈
yko=影
ykp=硬盘
ykr=萦绕
yks=缨
ykt=樱桃
yku=硬
ykv=迎战
ykw=赢
ykw=嬴
ykx=影响
yky=应用
ykz=迎
yl=原来
ym=郁闷
yn=云南
yo=哟
yok=哟
yp=一片
yq=要求
yr=元
yra=冤案
yrb=冤
yrc=苑
yrd=源
yrd=沅
yre=院
yrf=援
yrg=缘故
yrh=怨恨
yri=原
yri=螈
yrk=员
yrl=原来
yrm=橼
yrn=媛
yrp=爰
yrq=猿
yrr=圆润
yrs=缘
yrt=袁
yru=原始
yrv=箢
yrw=瑗
yrx=怨
yrx=鸳
yry=鸢
yrz=远
ys=用
ysa=鳙
ysb=痈
ysc=用餐
ysd=永
ysd=泳
ysf=拥
ysg=庸
ysh=拥护
ysi=蛹
ysj=镛
ysk=咏
ysm=勇猛
yso=臃
ysp=用品
ysq=勇气
ysr=佣
yss=勇
yst=墉
ysu=勇士
ysv=邕
ysw=雍
ysx=慵
ysy=勇于
ysz=踊
yt=月
ytb=月报
ytc=粤菜
ytd=瀹
ytf=月份
ytg=月光
yth=约会
yti=月初
ytj=钺
ytk=曰
ytm=阅
ytn=月内
yto=刖
ytp=乐
ytq=岳
ytr=龠
yts=约
ytt=越
ytu=约束
ytv=乐章
ytw=玥
ytx=悦
yty=说
ytz=跃
yu=与
yua=于
yub=宇
yub=瘐
yuc=芋
yuc=萸
yud=鱼
yud=浴
yue=屿
yuf=揄
yug=鬻
yuh=煜
yui=御
yuj=钰
yuk=喻
yuk=圄
yul=禺
yum=驭
yun=娱
yuo=昱
yup=禹
yuq=狱
yur=余
yur=觎
yus=预
yut=域
yuu=郁
yuv=聿
yuw=玉
yux=羽
yuy=语
yuz=遇
yuz=逾
yv=一直

yw=因为


yx=一下
yy=云
yyb=匀
yyc=芸
yyd=殒
yye=陨
yyf=孕妇
yyg=云贵
yyh=蕴含
yyi=匀称
yyj=云集
yyk=郧
yyl=韵
yym=韵母
yyn=孕
yyo=晕
yyq=氲
yys=允
yys=纭
yyu=熨
yyv=筠
yyw=韫
yyx=愠
yyy=酝
yyz=运
yz=有
yza=鱿
yzb=疣
yzc=莜
yzd=游
yze=幽
yzf=邮费
yzg=有关
yzh=黝
yzi=蝣
yzj=铀
yzk=呦
yzl=由
yzm=柚
yzp=祐
yzq=犹
yzr=优
yzs=有所
yzt=犹太
yzu=右
yzv=又
yzw=尤为
yzx=忧
yzy=邮
yzz=又在
z=在
za=杂
zab=咋办
zac=杂草
zad=咋地
zaf=扎
zag=咋搞
zah=杂货
zaj=杂
zak=咋
zak=咂
zal=咋了
zam=柞
zan=杂念
zao=臜
zap=杂牌
zas=杂色
zat=杂谈
zau=砸
zav=杂质
zaw=杂文
zax=杂项
zay=杂音
zaz=咂嘴
zb=咋办
zc=早
zca=枣
zcb=皂
zcc=藻
zcd=澡
zcf=造访
zcg=糟糕
zch=灶
zci=蚤
zcj=造就
zck=噪
zcl=糟了
zcm=糟
zcn=早年
zco=早
zcp=早盘
zcq=早期
zcr=早日
zcs=早死
zct=糟蹋
zcu=早上
zcv=造纸
zcw=早晚
zcx=造型
zcy=凿
zcz=造
zd=再
zda=再
zdb=灾
zdc=再次
zdd=再度
zde=崽
zdi=在场
zdj=再见
zdk=载客
zdl=再来
zdm=在忙
zdn=灾难
zdp=栽培
zdq=灾区
zdr=仔
zds=再三
zdt=在逃
zdu=载
zdv=甾
zdw=在外
zdx=再现
zdz=再造
ze=则
zeb=责备
zed=泽
zef=责
zeg=责怪
zei=仄
zej=帻
zek=啧
zel=责令
zem=责骂
zen=责难
zeo=昃
zeq=择期
zer=责任
zeu=则是
zev=笮
zew=责问
zey=择优
zez=迮
zf=怎
zfg=怎敢
zfh=怎会
zfk=怎可
zfm=怎么
zfn=怎能
zfv=怎
zfy=谮
zg=增
zgb=曾
zgc=增仓
zgd=增多
zgf=增发
zgg=增高
zgh=憎恨
zgj=锃
zgk=赠
zgl=增量
zgp=赠品
zgq=增强
zgs=缯
zgu=增收
zgv=增长
zgw=憎恶
zgx=憎
zgy=增援
zgz=增资
zh=藏
zha=臧
zhb=藏胞
zhc=葬
zhg=赃官
zhh=脏活
zhk=赃
zhl=脏了
zhm=驵
zho=脏
zhp=奘
zhs=葬送
zhv=奘
zhw=臧
zhy=藏语
zhz=藏族
zi=字
zia=鲻
zib=兹
zic=茈
zid=资
zid=渍
zie=嵫
zif=字符
zig=资格
zih=秭
zii=辎
zij=锱
zik=吱
zil=耔
zim=梓
zin=姊
zio=眦
zip=自
ziq=自强
zir=仔
zis=缁
zit=趑
ziu=资深
ziv=子
ziw=滋味
zix=资讯
ziy=谘
ziz=孜
zj=自己
zja=暂按
zjb=暂不
zjc=暂存
zjf=攒
zjg=赞歌
zjh=暂缓
zji=暂
zjj=咱就
zjk=咱
zjm=糌
zjn=赞
zjq=暂缺
zjs=赞颂
zjt=趱
zju=暂时
zjv=簪
zjw=瓒
zjx=暂行
zjy=赞扬
zk=走开
zl=走了
zm=怎么
zn=怎能
zo=做
zoa=作案
zob=左边
zoc=左侧
zod=做到
zoe=阼
zof=撮
zog=座
zoh=做好
zoi=作出
zoj=作家
zok=嘬
zol=做了
zom=柞
zon=作弄
zoo=昨
zop=祚
zoq=作曲
zor=作
zos=作祟
zot=昨天
zou=左
zov=笮
zow=琢
zox=怍
zoy=酢
zoz=坐在
zp=作品
zq=早期
zr=自然
zrd=钻到
zrf=攥
zri=钻出
zrj=钻
zrk=赚
zrr=钻入
zrs=缵
zrt=钻头
zru=钻石
zrv=纂
zrx=钻心
zry=钻研
zrz=躜
zs=总
zs=总算
zsa=鬃
zsb=宗
zsc=总裁
zsd=总得
zse=总额
zsf=总分
zsg=总共
zsh=综合
zsi=总称
zsj=总结
zsk=总括
zsl=总理
zsm=棕
zsn=总能
zso=腙
zsp=总怕
zsq=纵情
zsr=偬
zss=纵
zst=总体
zsu=宗师
zsv=总之
zsw=总务
zsx=纵向
zsy=纵有
zsz=踪
zt=昨天
zu=组
zua=阻碍
zuc=菹
zud=阻挡
zue=阻
zuf=族
zug=足够
zuh=租
zui=组成
zuj=镞
zuk=足
zul=租赁
zum=驵
zun=阻挠
zup=祖
zuq=足球
zur=俎
zus=组
zut=组图
zuu=租售
zuv=阻止
zuw=卒
zux=祖先
zuy=诅
zuz=足足
zv=最
zva=最爱
zvb=嘴巴
zvc=蕞
zvd=最大
zve=罪恶
zvf=罪犯
zvg=最高
zvh=最好
zvi=最长
zvj=最近
zvk=嘴
zvl=嘴里
zvm=最美
zvn=最能
zvo=最
zvp=最怕
zvr=最热
zvs=罪
zvt=醉态
zvv=觜
zvw=最为
zvx=最新
zvy=醉
zvz=最早
zw=贼
zwd=贼胆
zwi=贼船
zwk=贼
zwl=贼亮
zwr=贼人
zww=贼窝
zwy=贼眼
zwz=贼赃
zx=在线
zy=怎样
zya=鳟
zyb=尊
zyf=撙
zyg=尊贵
zyi=尊称
zyj=尊敬
zyl=遵令
zym=樽
zyr=尊容
zyv=尊重
zyx=遵循
zyy=尊严
zyz=遵
zz=走
zza=鲰
zzb=走吧
zzd=邹
zze=陬
zzf=奏
zzg=走高
zzh=走好
zzi=走出
zzj=走进
zzk=走开
zzl=走了
zzm=驺
zzq=走强
zzr=走人
zzs=走私
zzt=走台
zzu=走势
zzv=走着
zzw=走完
zzy=诹
zzz=走在
eb=背
ed=倒
ef=复
eg=管
eh=鹤
ej=极
eji=计
ek=块
el=立
em=美
ep=片
et=帖
eu=十
euj=闪
ev=之
evi=智
ew=位
bjo=背景
dno=电脑
dye=单元
idl=成都
uhb=伤害
idg=程度
hyx=回忆
iix=尝尝
jrp=加入
jdb=决定
jdi=觉得
jdy=绝对
jjd=渐渐
jjr=仅仅
jlv=精力
jlw=经理
jur=即使
jva=截至
jvl=截止
kdb=肯定
mmx=慢慢
sdg=速度
ujs=世纪
uub=事实
uuy=试试
uwy=失误
vhf=指挥
vjb=整句
vue=指示
vvu=正直
wvu=未知
xgj=修改
xxm=想想
